Forrest Gump	155	121	42	9	2	329
Shawshank Redemption, The	202	87	24	2	2	317
Pulp Fiction	167	89	34	9	8	307
Silence of the Lambs, The	128	111	31	5	4	279
Matrix, The	150	90	24	5	9	278
Star Wars: Episode IV - A New Hope	128	92	19	10	2	251
Jurassic Park	48	120	53	15	2	238
Braveheart	101	87	36	8	5	237
Terminator 2: Judgment Day	83	90	43	3	5	224
Schindler's List	128	60	20	5	7	220
Fight Club	130	66	13	6	3	218
Toy Story	65	100	42	7	1	215
Star Wars: Episode V - The Empire Strikes Back	108	72	24	6	1	211
Usual Suspects, The	113	61	25	3	2	204
American Beauty	86	89	17	4	8	204
Seven (a.k.a. Se7en)	81	76	34	8	4	203
Independence Day (a.k.a. ID4)	36	80	60	19	7	202
Apollo 13	57	85	46	12	1	201
Raiders of the Lost Ark (Indiana Jones and the Raiders of the Lost Ark)	89	94	12	2	3	200
Lord of the Rings: The Fellowship of the Ring, The	100	68	17	10	3	198
Star Wars: Episode VI - Return of the Jedi	92	73	21	8	2	196
Godfather, The	114	51	17	9	1	192
Fugitive, The	58	93	35	3	1	190
Batman	25	58	95	10	1	189
Saving Private Ryan	85	76	22	4	1	188
Lord of the Rings: The Two Towers, The	80	76	20	10	2	188
Lord of the Rings: The Return of the King, The	87	73	16	7	2	185
Aladdin	46	81	44	10	2	183
Fargo	81	66	26	8	0	181
Sixth Sense, The	64	76	26	9	4	179
True Lies	31	60	68	17	2	178
Twelve Monkeys (a.k.a. 12 Monkeys)	57	83	33	3	1	177
Lion King, The	58	72	36	5	1	172
Speed	29	70	56	13	3	171
Back to the Future	68	75	19	7	2	171
Gladiator	66	72	18	9	5	170
Shrek	56	79	23	8	4	170
Men in Black (a.k.a. MIB)	22	84	39	17	3	165
Dances with Wolves	43	74	37	9	1	164
Mission: Impossible	25	67	58	7	5	162
Ace Ventura: Pet Detective	17	46	54	32	12	161
Memento	83	57	10	5	4	159
Mask, The	14	52	65	15	11	157
Dark Knight, The	79	58	9	3	0	149
Pirates of the Caribbean: The Curse of the Black Pearl	40	72	31	4	2	149
Alien	54	64	16	10	2	146
Beauty and the Beast	38	53	50	5	0	146
Die Hard	43	64	29	6	3	145
Die Hard: With a Vengeance	29	48	53	12	2	144
Mrs. Doubtfire	17	58	54	11	4	144
Groundhog Day	49	62	27	3	2	143
Inception	69	52	13	6	3	143
Princess Bride, The	75	48	16	3	0	142
Good Will Hunting	61	55	22	2	1	141
Finding Nemo	49	72	16	2	2	141
Indiana Jones and the Last Crusade	50	71	15	2	2	140
Titanic	21	64	33	16	6	140
Star Wars: Episode I - The Phantom Menace	15	52	36	26	11	140
Stargate	15	53	55	15	2	140
Batman Forever	7	24	74	23	9	137
Monty Python and the Holy Grail	68	49	13	4	2	136
Pretty Woman	17	58	51	6	3	135
One Flew Over the Cuckoo's Nest	64	52	15	1	1	133
Dumb & Dumber (Dumb and Dumber)	18	33	51	18	13	133
X-Men	26	74	25	5	3	133
Léon: The Professional (a.k.a. The Professional) (Léon)	54	51	24	1	3	133
Monsters, Inc.	35	74	18	4	1	132
GoldenEye	20	55	45	9	3	132
Eternal Sunshine of the Spotless Mind	62	57	9	2	1	131
Kill Bill: Vol. 1	54	56	16	3	2	131
Terminator, The	33	76	17	2	3	131
Reservoir Dogs	61	54	13	2	1	131
Godfather: Part II, The	68	46	12	1	2	129
American History X	63	53	13	0	0	129
Babe	30	53	30	11	4	128
Aliens	54	44	18	7	3	126
Goodfellas	61	56	7	2	0	126
Incredibles, The	32	73	15	3	2	125
Truman Show, The	37	62	21	3	2	125
Blade Runner	58	46	13	5	2	124
Twister	19	37	47	14	6	123
Beautiful Mind, A	43	62	16	0	2	123
Spider-Man	20	65	26	6	5	122
E.T. the Extra-Terrestrial	39	48	21	10	4	122
Austin Powers: The Spy Who Shagged Me	19	42	37	10	13	121
Rock, The	21	56	35	5	4	121
Clockwork Orange, A	50	47	15	4	4	120
Minority Report	22	71	15	8	4	120
Ghostbusters (a.k.a. Ghost Busters)	30	57	24	9	0	120
Amelie (Fabuleux destin d'Amélie Poulain, Le)	59	46	10	3	2	120
Willy Wonka & the Chocolate Factory	36	52	26	2	3	119
Ocean's Eleven	32	67	16	1	3	119
Batman Begins	38	55	17	5	1	116
Fifth Element, The	33	50	25	6	2	116
Home Alone	9	29	50	19	9	116
Waterworld	2	36	47	20	10	115
Ghost	18	39	44	12	2	115
Catch Me If You Can	36	63	10	6	0	115
Breakfast Club, The	28	55	21	9	0	113
Net, The	9	28	51	14	10	112
Bourne Identity, The	32	60	11	7	2	112
Green Mile, The	46	55	9	0	1	111
Crouching Tiger, Hidden Dragon (Wo hu cang long)	42	43	17	3	5	110
Kill Bill: Vol. 2	37	51	15	4	3	110
Jumanji	14	47	40	7	2	110
Clear and Present Danger	14	49	40	7	0	110
Donnie Darko	46	47	9	4	3	109
Interview with the Vampire: The Vampire Chronicles	19	42	36	5	7	109
Shining, The	41	54	11	3	0	109
2001: A Space Odyssey	41	43	11	10	4	109
Ferris Bueller's Day Off	32	54	17	5	1	109
Star Trek: Generations	11	38	49	8	2	108
Indiana Jones and the Temple of Doom	20	55	23	9	1	108
Harry Potter and the Sorcerer's Stone (a.k.a. Harry Potter and the Philosopher's Stone)	29	49	24	5	0	107
Departed, The	61	37	8	0	1	107
Apocalypse Now	54	37	13	3	0	107
Sleepless in Seattle	14	41	42	7	2	106
Big Lebowski, The	46	39	13	2	6	106
There's Something About Mary	22	49	28	4	2	105
Up	39	49	15	1	1	105
Taxi Driver	47	36	17	4	0	104
Clueless	14	33	42	7	8	104
WALL·E	45	47	7	4	1	104
Clerks	31	49	18	3	3	104
American Pie	17	44	25	13	4	103
Four Weddings and a Funeral	18	47	25	5	8	103
Crimson Tide	17	48	30	6	2	103
Heat	32	44	23	2	1	102
Trainspotting	41	47	10	3	1	102
Harry Potter and the Chamber of Secrets	25	40	30	5	2	102
Full Metal Jacket	43	42	14	2	1	102
Outbreak	12	37	45	2	5	101
Firm, The	13	41	42	3	2	101
Cliffhanger	6	19	59	11	6	101
V for Vendetta	29	57	11	1	2	100
Casablanca	54	33	10	1	2	100
Austin Powers: International Man of Mystery	15	52	23	8	2	100
Cast Away	23	51	22	4	0	100
Being John Malkovich	34	46	14	3	2	99
Happy Gilmore	17	39	30	10	3	99
While You Were Sleeping	13	37	40	6	2	98
L.A. Confidential	38	45	10	3	1	97
Avatar	27	35	24	7	4	97
Who Framed Roger Rabbit?	15	47	27	5	3	97
Dr. Strangelove or: How I Learned to Stop Worrying and Love the Bomb	56	28	10	2	1	97
Toy Story 2	33	36	24	4	0	97
Matrix Reloaded, The	15	40	28	9	4	96
Rain Man	23	51	16	6	0	96
As Good as It Gets	19	52	19	3	3	96
Requiem for a Dream	40	36	13	2	5	96
O Brother, Where Art Thou?	27	44	16	5	2	94
Office Space	44	34	12	4	0	94
Iron Man	31	42	16	4	1	94
Snatch	47	33	11	1	1	93
Nightmare Before Christmas, The	15	47	21	5	5	93
Harry Potter and the Prisoner of Azkaban	31	43	17	2	0	93
Shrek 2	17	48	18	6	3	92
Shakespeare in Love	24	46	11	8	3	92
Wizard of Oz, The	34	34	16	5	3	92
Bug's Life, A	12	45	29	3	3	92
Natural Born Killers	14	26	32	12	8	92
Star Wars: Episode II - Attack of the Clones	10	37	27	8	10	92
Armageddon	11	24	37	12	8	92
Beetlejuice	15	41	25	7	3	91
Meet the Parents	14	40	25	10	2	91
Big	17	49	19	4	2	91
Jaws	35	36	15	4	1	91
Star Trek: First Contact	30	38	17	3	3	91
Stand by Me	27	49	13	2	0	91
Hunt for Red October, The	26	42	20	0	2	90
Prestige, The	38	41	8	3	0	90
Monty Python's Life of Brian	39	33	7	6	4	89
Get Shorty	9	40	32	6	2	89
Back to the Future Part III	13	32	33	8	2	88
Inglourious Basterds	41	40	5	0	2	88
Total Recall	16	40	27	5	0	88
Life Is Beautiful (La Vita è bella)	49	24	8	4	3	88
Ace Ventura: When Nature Calls	5	24	21	28	10	88
Back to the Future Part II	19	34	23	6	5	87
Airplane!	26	41	14	3	3	87
Mummy, The	11	32	24	12	8	87
Spirited Away (Sen to Chihiro no kamikakushi)	42	34	9	1	1	87
Mars Attacks!	11	27	25	15	8	86
Gattaca	29	39	14	4	0	86
Dead Poets Society	36	32	12	4	2	86
Birdcage, The	8	40	32	3	3	86
When Harry Met Sally...	26	40	17	2	0	85
Ice Age	14	56	10	4	1	85
Jerry Maguire	16	42	20	4	3	85
Rear Window	45	30	8	0	1	84
Addams Family Values	4	22	46	10	2	84
Sin City	28	38	14	3	1	84
Broken Arrow	7	21	35	16	5	84
Blues Brothers, The	24	36	20	2	2	84
Psycho	35	30	15	2	1	83
Almost Famous	25	43	11	4	0	83
Top Gun	12	31	28	7	5	83
Nutty Professor, The	7	18	24	21	12	82
Casino	32	32	14	2	2	82
Contact	23	30	22	5	2	82
Demolition Man	5	27	34	10	5	81
Bourne Ultimatum, The	20	40	16	2	3	81
Santa Clause, The	10	25	33	7	6	81
Casino Royale	30	36	13	2	0	81
Quiz Show	11	30	35	4	1	81
Pan's Labyrinth (Laberinto del fauno, El)	26	36	13	5	1	81
300	20	41	13	4	2	80
Mr. Holland's Opus	24	24	25	4	3	80
Edward Scissorhands	8	52	18	2	0	80
Starship Troopers	14	31	19	10	6	80
Dogma	21	33	18	4	3	79
Graduate, The	36	28	10	4	1	79
Matrix Revolutions, The	12	29	20	13	5	79
Spider-Man 2	25	33	20	0	1	79
Chicken Run	13	35	24	5	1	78
Star Wars: Episode III - Revenge of the Sith	15	34	16	8	5	78
What's Eating Gilbert Grape	20	34	19	3	1	77
Face/Off	12	29	26	6	4	77
Snow White and the Seven Dwarfs	12	34	28	3	0	77
Shaun of the Dead	34	29	10	2	2	77
Mission: Impossible II	4	19	28	17	9	77
Game, The	24	32	12	7	2	77
Little Miss Sunshine	26	36	12	2	1	77
Dave	5	40	29	2	0	76
Amadeus	36	29	10	1	0	76
X2: X-Men United	18	37	18	2	1	76
Leaving Las Vegas	21	25	19	7	4	76
Hangover, The	19	35	16	1	5	76
Dark Knight Rises, The	30	35	7	1	3	76
South Park: Bigger, Longer and Uncut	27	31	13	2	3	76
Run Lola Run (Lola rennt)	22	43	9	1	0	75
City of God (Cidade de Deus)	32	36	5	1	1	75
Bourne Supremacy, The	19	39	14	2	1	75
High Fidelity	16	39	13	4	3	75
Galaxy Quest	14	37	13	9	2	75
Lethal Weapon	12	40	20	3	0	75
40-Year-Old Virgin, The	15	34	19	5	1	74
Lost in Translation	31	29	12	2	0	74
Maverick	8	33	27	4	2	74
Liar Liar	6	23	31	11	3	74
Interstellar	33	23	15	0	2	73
Unbreakable	17	30	16	6	4	73
Good, the Bad and the Ugly, The (Buono, il brutto, il cattivo, Il)	32	30	7	2	1	72
Charlie's Angels	2	21	24	18	7	72
Pirates of the Caribbean: Dead Man's Chest	14	33	20	3	2	72
Ratatouille	20	36	15	1	0	72
Fish Called Wanda, A	25	28	13	5	0	71
Harry Potter and the Goblet of Fire	17	39	14	1	0	71
Slumdog Millionaire	25	33	7	2	4	71
Mary Poppins	22	32	14	2	1	71
Django Unchained	30	27	10	2	2	71
Bruce Almighty	7	29	28	7	0	71
In the Line of Fire	9	35	26	0	0	70
Ed Wood	15	32	16	6	1	70
Scream	11	23	23	6	7	70
RoboCop	11	26	23	7	3	70
Erin Brockovich	9	37	19	5	0	70
American President, The	12	33	21	3	1	70
Traffic	24	34	7	4	1	70
Citizen Kane	30	28	6	4	1	69
Young Frankenstein	23	33	10	2	1	69
Big Fish	22	35	7	3	2	69
Robin Hood: Men in Tights	8	22	21	14	4	69
Avengers, The	26	29	10	2	2	69
Patriot, The	12	30	16	6	4	68
Honey, I Shrunk the Kids	0	18	30	16	4	68
Pocahontas	8	21	25	9	5	68
Royal Tenenbaums, The	22	29	8	7	2	68
Legends of the Fall	7	29	23	6	3	68
Die Hard 2	8	30	22	7	1	68
Grease	10	22	22	8	6	68
Lock, Stock & Two Smoking Barrels	28	27	10	0	2	67
Lost World: Jurassic Park, The	3	17	24	15	8	67
Shutter Island	34	22	8	1	2	67
Dead Man Walking	16	36	11	1	3	67
Little Mermaid, The	12	25	21	6	3	67
Enemy of the State	12	26	22	6	1	67
Scarface	27	30	7	2	1	67
Sense and Sensibility	21	27	13	1	5	67
Desperado	15	22	23	3	3	66
This Is Spinal Tap	22	33	9	2	0	66
Philadelphia	12	32	17	3	2	66
School of Rock	7	33	21	4	1	66
Juno	21	30	10	3	1	65
Untouchables, The	18	34	12	1	0	65
Dragonheart	2	20	33	8	2	65
District 9	22	29	8	4	2	65
Bridget Jones's Diary	13	34	13	4	1	65
True Romance	20	24	17	4	0	65
Tombstone	20	27	12	4	2	65
Borat: Cultural Learnings of America for Make Benefit Glorious Nation of Kazakhstan	13	24	19	3	6	65
Austin Powers in Goldmember	3	23	22	10	7	65
Eraser	5	18	28	8	5	64
Sound of Music, The	28	19	10	7	0	64
Sting, The	23	30	7	2	2	64
No Country for Old Men	27	23	9	2	3	64
Crow, The	15	20	22	7	0	64
Miss Congeniality	6	21	23	11	3	64
Rocky	21	29	8	4	2	64
Blair Witch Project, The	9	18	13	10	14	64
Legally Blonde	5	28	22	6	3	64
Children of Men	25	27	8	4	0	64
Platoon	22	30	8	1	2	63
Rocky Horror Picture Show, The	15	15	22	7	4	63
Signs	5	29	16	9	4	63
Coneheads	2	7	25	17	12	63
Star Trek II: The Wrath of Khan	21	21	14	3	3	62
Butch Cassidy and the Sundance Kid	22	24	13	2	1	62
Chronicles of Narnia: The Lion, the Witch and the Wardrobe, The	11	27	18	4	2	62
Blazing Saddles	23	27	8	3	1	62
Last Samurai, The	17	37	7	1	0	62
Judge Dredd	2	11	28	11	10	62
Animal House	18	23	15	2	4	62
Sleepy Hollow	5	36	14	6	1	62
Abyss, The	6	34	17	2	3	62
Casper	5	12	25	12	8	62
I Am Legend	8	33	17	3	1	62
Piano, The	10	30	14	4	3	61
Gone in 60 Seconds	4	27	21	9	0	61
Pleasantville	12	26	13	8	2	61
Predator	12	29	11	7	2	61
I, Robot	12	27	18	2	2	61
Superman	8	31	19	2	1	61
Three Musketeers, The	6	18	28	9	0	61
Men in Black II (a.k.a. MIIB) (a.k.a. MIB 2)	4	15	28	14	0	61
Charlie and the Chocolate Factory	2	26	22	8	3	61
Hot Fuzz	28	25	4	2	2	61
Wayne's World	12	25	16	6	2	61
Pinocchio	12	23	17	6	2	60
Vertigo	25	24	8	1	2	60
Mask of Zorro, The	5	25	18	8	4	60
My Big Fat Greek Wedding	8	27	13	8	4	60
Close Encounters of the Third Kind	13	30	14	2	1	60
Hot Shots! Part Deux	5	14	22	13	6	60
Batman Returns	3	20	23	11	3	60
Love Actually	21	26	9	2	1	59
Star Trek	14	38	4	1	2	59
Brazil	28	23	6	2	0	59
Mr. & Mrs. Smith	8	24	18	7	2	59
Grosse Pointe Blank	15	21	16	7	0	59
Spaceballs	7	31	14	6	1	59
Guardians of the Galaxy	27	23	7	1	1	59
American Psycho	22	22	9	4	2	59
Beverly Hills Cop III	2	9	28	14	6	59
Italian Job, The	11	31	14	3	0	59
Chinatown	30	24	2	3	0	59
My Cousin Vinny	7	19	25	4	4	59
Con Air	2	23	22	7	5	59
To Kill a Mockingbird	25	22	10	0	1	58
King's Speech, The	20	31	7	0	0	58
Blade	7	27	14	9	1	58
It's a Wonderful Life	26	21	6	4	1	58
Wedding Crashers	7	31	16	4	0	58
Harry Potter and the Half-Blood Prince	18	28	10	2	0	58
Truth About Cats & Dogs, The	5	24	24	4	1	58
Sherlock Holmes	19	26	12	1	0	58
Annie Hall	23	19	9	6	1	58
28 Days Later	23	27	5	3	0	58
Harry Potter and the Order of the Phoenix	20	24	13	0	1	58
Raising Arizona	22	25	6	4	1	58
Bowling for Columbine	14	33	10	0	1	58
Air Force One	4	22	29	3	0	58
Naked Gun 33 1/3: The Final Insult	4	18	24	9	3	58
Few Good Men, A	10	32	14	0	1	57
Crocodile Dundee	4	22	21	8	2	57
12 Angry Men	28	23	3	0	3	57
Anchorman: The Legend of Ron Burgundy	15	29	12	1	0	57
North by Northwest	25	24	7	1	0	57
Client, The	6	20	26	4	1	57
Cool Hand Luke	26	28	3	0	0	57
Goonies, The	13	22	16	6	0	57
Social Network, The	18	29	7	2	1	57
Congo	4	12	26	9	6	57
Field of Dreams	13	19	17	4	3	56
Wallace & Gromit: The Wrong Trousers	26	19	7	2	2	56
Pirates of the Caribbean: At World's End	11	26	10	8	1	56
Rushmore	16	19	12	6	3	56
Planet of the Apes	13	26	14	3	0	56
Wedding Singer, The	7	25	20	3	1	56
Election	13	25	11	6	1	56
Full Monty, The	10	33	9	3	1	56
Notting Hill	9	26	14	3	4	56
A.I. Artificial Intelligence	6	25	20	3	2	56
Christmas Story, A	20	23	9	2	1	55
Others, The	17	22	12	1	3	55
City Slickers II: The Legend of Curly's Gold	2	6	29	10	8	55
From Dusk Till Dawn	10	26	9	8	2	55
Lady and the Tramp	7	24	18	3	3	55
Gangs of New York	12	23	14	4	2	55
Moulin Rouge	15	23	10	3	4	55
Superbad	19	25	8	2	1	55
Toy Story 3	21	29	2	3	0	55
What Women Want	3	24	17	9	1	54
Sabrina	4	18	24	3	5	54
Zoolander	12	20	16	5	1	54
Wolf of Wall Street, The	23	18	9	1	3	54
The Hunger Games	9	28	10	4	3	54
First Knight	10	13	15	11	5	54
Cable Guy, The	6	10	19	14	5	54
Deadpool	21	19	9	4	1	54
Romancing the Stone	4	26	20	4	0	54
10 Things I Hate About You	12	21	16	2	3	54
Kung Fu Panda	6	31	14	0	3	54
Last Action Hero	4	11	27	7	4	53
Space Jam	3	11	22	9	8	53
Best in Show	13	23	15	1	1	53
Jungle Book, The	15	22	13	3	0	53
Fantasia	16	24	8	3	2	53
Goldfinger	11	29	12	1	0	53
Blood Diamond	13	28	10	1	1	53
Zombieland	17	27	5	3	1	53
Arachnophobia	2	13	25	9	4	53
Exorcist, The	16	23	10	3	1	53
Eyes Wide Shut	12	18	15	4	4	53
How to Train Your Dragon	21	21	9	2	0	53
Johnny Mnemonic	3	12	16	15	7	53
Wild Wild West	1	4	19	17	12	53
Hook	6	23	17	6	1	53
Chasing Amy	14	21	9	6	2	52
Knocked Up	10	29	11	2	0	52
Million Dollar Baby	14	29	7	1	1	52
Mystic River	14	25	9	3	1	52
Disclosure	6	20	23	3	0	52
Grumpier Old Men	6	17	22	3	4	52
Caddyshack	16	22	8	5	1	52
Grand Budapest Hotel, The	13	27	9	2	1	52
X-Men: The Last Stand	8	23	13	7	1	52
Magnolia	12	26	8	4	2	52
Donnie Brasco	11	25	14	2	0	52
Army of Darkness	21	21	6	3	0	51
The Devil's Advocate	9	19	16	5	2	51
Bad Boys	3	22	19	5	2	51
Splash	2	23	16	7	3	51
Mulholland Drive	15	24	8	4	0	51
Training Day	12	28	8	3	0	51
Blow	12	27	10	2	0	51
Some Like It Hot	18	23	8	1	0	50
Harry Potter and the Deathly Hallows: Part 2	20	20	7	2	1	50
War of the Worlds	4	23	13	9	1	50
Scary Movie	7	11	15	14	3	50
Super Size Me	8	27	10	2	3	50
Tommy Boy	18	15	12	3	2	50
Tron	3	20	23	4	0	50
The Imitation Game	21	20	8	1	0	50
Crash	16	25	6	3	0	50
Day After Tomorrow, The	4	16	21	8	1	50
You've Got Mail	4	22	14	5	5	50
Serenity	17	27	4	1	1	50
Black Hawk Down	13	25	9	3	0	50
Skyfall	14	26	8	1	1	50
Road to Perdition	8	23	13	5	0	49
Planet of the Apes	1	14	18	10	6	49
Billy Madison	8	16	17	5	3	49
Da Vinci Code, The	0	25	19	2	3	49
James and the Giant Peach	8	16	20	2	3	49
Superman II	2	15	22	8	2	49
Sixteen Candles	9	22	14	4	0	49
Talented Mr. Ripley, The	6	24	11	3	5	49
Chicago	13	24	8	4	0	49
Father of the Bride Part II	4	9	27	8	1	49
Dark City	17	21	6	2	2	48
The Martian	14	29	5	0	0	48
Troy	7	21	17	1	2	48
Garden State	15	20	10	2	1	48
Wallace & Gromit: A Close Shave	18	19	7	1	3	48
Nine Months	2	11	24	6	5	48
Thomas Crown Affair, The	8	24	12	3	1	48
Hotel Rwanda	13	28	3	2	2	48
Jackie Brown	8	28	9	3	0	48
Big Daddy	2	23	15	6	2	48
Highlander	15	18	10	5	0	48
Seven Samurai (Shichinin no samurai)	23	20	3	2	0	48
Princess Mononoke (Mononoke-hime)	15	26	5	0	2	48
Lethal Weapon 2	3	19	19	4	2	47
Iron Man 2	4	29	11	2	1	47
Analyze This	1	17	20	8	1	47
50 First Dates	8	25	9	4	1	47
Basic Instinct	3	17	22	4	1	47
Alien³ (a.k.a. Alien 3)	2	19	18	6	2	47
Chocolat	11	18	12	5	1	47
Terminal, The	6	22	13	3	3	47
Mad Max: Fury Road	16	17	10	4	0	47
Pi	14	25	5	2	1	47
Sling Blade	14	21	8	2	2	47
Hunchback of Notre Dame, The	3	22	16	5	1	47
Poltergeist	3	26	15	2	1	47
Ghostbusters II	2	14	22	7	2	47
Harry Potter and the Deathly Hallows: Part 1	17	20	8	2	0	47
101 Dalmatians	3	12	25	4	3	47
Ring, The	2	24	13	7	1	47
Singin' in the Rain	22	16	6	2	1	47
Rumble in the Bronx (Hont faan kui)	8	17	17	3	1	46
Sneakers	2	25	18	1	0	46
The Butterfly Effect	11	25	6	1	3	46
Adaptation	16	24	4	1	1	46
Mortal Kombat	1	11	13	13	8	46
Gran Torino	14	26	5	1	0	46
Lethal Weapon 3	3	11	20	9	3	46
Pursuit of Happyness, The	12	22	10	2	0	46
Me, Myself & Irene	1	21	14	8	2	46
M*A*S*H (a.k.a. MASH)	14	22	6	3	1	46
Beverly Hills Cop	2	26	13	5	0	46
Simpsons Movie, The	6	29	8	3	0	46
Phenomenon	5	16	20	4	1	46
Blue Velvet	16	21	6	2	1	46
Pianist, The	24	16	4	1	1	46
Fear and Loathing in Las Vegas	17	18	10	1	0	46
Thing, The	16	19	5	4	1	45
Bill & Ted's Excellent Adventure	8	23	14	0	0	45
Hitch	5	16	17	7	0	45
Alien: Resurrection	3	13	15	10	4	45
League of Their Own, A	2	24	18	1	0	45
Bridge on the River Kwai, The	23	14	5	1	2	45
Tomorrow Never Dies	5	13	18	6	3	45
Species	0	9	21	10	5	45
Fast and the Furious, The	5	11	23	4	2	45
Lawrence of Arabia	25	14	4	2	0	45
Antz	3	17	20	5	0	45
Gone with the Wind	13	13	14	4	1	45
Terminator 3: Rise of the Machines	3	17	19	4	2	45
Payback	7	17	15	4	2	45
French Kiss	6	16	20	2	1	45
Cell, The	5	13	18	5	4	45
Star Trek: The Motion Picture	2	14	19	7	3	45
Godfather: Part III, The	7	15	17	4	2	45
Three Kings	8	24	12	0	1	45
American Pie 2	8	15	10	7	5	45
English Patient, The	10	19	13	2	1	45
Aristocats, The	5	19	16	4	1	45
Unforgiven	18	20	6	1	0	45
Mulan	6	25	11	3	0	45
Mummy Returns, The	5	19	12	4	5	45
Escape from L.A.	4	12	12	14	2	44
Perfect Storm, The	4	17	17	4	2	44
Equilibrium	11	27	5	1	0	44
Collateral	11	22	9	2	0	44
Edge of Tomorrow	15	24	4	1	0	44
Corpse Bride	4	27	12	1	0	44
Birds, The	5	26	10	2	1	44
Hitchhiker's Guide to the Galaxy, The	5	24	9	4	2	44
Spider-Man 3	4	16	17	3	4	44
Maltese Falcon, The	19	20	5	0	0	44
Vanilla Sky	4	23	13	3	1	44
About a Boy	7	29	6	2	0	44
Rob Roy	7	17	16	3	1	44
Scott Pilgrim vs. the World	13	17	10	3	1	44
Misery	12	23	7	2	0	44
101 Dalmatians (One Hundred and One Dalmatians)	3	22	15	4	0	44
Stranger than Fiction	13	23	3	2	3	44
X-Men: First Class	10	27	5	0	1	43
Kick-Ass	10	22	9	1	1	43
Watchmen	15	22	5	1	0	43
Ronin	8	17	14	2	2	43
Conspiracy Theory	2	14	16	7	4	43
Good Morning, Vietnam	11	19	12	1	0	43
Shanghai Noon	2	20	12	7	2	43
Fly, The	5	17	16	4	1	43
Entrapment	2	16	12	11	2	43
Boondock Saints, The	25	15	3	0	0	43
Ocean's Twelve	7	15	15	4	2	43
Pearl Harbor	3	16	14	5	5	43
American Graffiti	13	19	10	1	0	43
Cocoon	1	21	14	7	0	43
Illusionist, The	12	21	7	3	0	43
Tin Cup	2	18	15	5	3	43
Inside Out	15	19	4	4	1	43
NeverEnding Story, The	10	17	10	6	0	43
Deep Impact	3	14	18	6	2	43
Deer Hunter, The	16	15	8	2	2	43
Star Trek IV: The Voyage Home	8	18	10	4	3	43
Great Escape, The	20	17	5	0	1	43
I.Q.	4	19	15	5	0	43
Much Ado About Nothing	10	20	10	3	0	43
Kingpin	6	15	16	5	0	42
Cinderella	7	14	19	2	0	42
Labyrinth	12	19	8	2	1	42
Rush Hour	3	19	16	2	2	42
That Thing You Do!	7	7	22	6	0	42
Whole Nine Yards, The	7	19	12	4	0	42
Little Women	10	21	10	1	0	42
(500) Days of Summer	11	21	6	2	2	42
Flintstones, The	1	2	18	13	8	42
X-Files: Fight the Future, The	6	18	12	5	1	42
Star Trek VI: The Undiscovered Country	6	18	10	4	4	42
Dirty Dancing	7	18	12	2	3	42
Batman & Robin	0	2	15	21	4	42
Star Trek III: The Search for Spock	1	20	16	4	1	42
Black Swan	11	22	3	4	2	42
Dazed and Confused	17	15	8	1	1	42
Carlito's Way	8	22	11	0	1	42
Naked Gun: From the Files of Police Squad!, The	7	17	13	3	2	42
Risky Business	5	18	14	4	1	42
Fast Times at Ridgemont High	4	23	11	3	1	42
Girl with the Dragon Tattoo, The	10	19	6	2	5	42
Crying Game, The	6	16	15	3	2	42
Runaway Bride	3	10	14	12	3	42
Taken	13	15	11	1	2	42
Heathers	11	16	12	0	2	41
Glory	14	23	4	0	0	41
Gremlins	5	18	13	3	2	41
In Bruges	19	18	4	0	0	41
Thelma & Louise	6	18	11	4	2	41
Big Hero 6	13	21	4	2	1	41
Executive Decision	5	14	15	6	1	41
Cars	6	18	13	3	1	41
Hellboy	7	17	12	3	2	41
Peter Pan	7	17	15	2	0	41
Striptease	2	4	16	12	7	41
Road Trip	2	18	12	7	2	41
Knight's Tale, A	7	15	15	1	3	41
Into the Wild	16	19	5	1	0	41
Time Bandits	9	20	9	2	1	41
8 Mile	4	20	11	3	3	41
Remember the Titans	10	21	8	1	1	41
Star Wars: Episode VII - The Force Awakens	14	21	5	0	1	41
So I Married an Axe Murderer	6	16	12	6	1	41
Cruel Intentions	4	17	9	9	1	40
Howl's Moving Castle (Hauru no ugoku shiro)	15	20	5	0	0	40
King Kong	3	22	11	4	0	40
Alice in Wonderland	5	17	14	1	3	40
Bend It Like Beckham	7	16	9	7	1	40
Hobbit: An Unexpected Journey, The	12	19	8	0	1	40
Searching for Bobby Fischer	11	18	11	0	0	40
Raging Bull	19	15	5	1	0	40
Road Warrior, The (Mad Max 2)	16	14	9	1	0	40
Boot, Das (Boat, The)	19	16	5	0	0	40
Madagascar	5	17	15	2	1	40
Don Juan DeMarco	4	21	14	0	1	40
Monty Python's The Meaning of Life	14	19	6	1	0	40
Nell	4	14	16	5	1	40
Inside Man	14	16	7	2	1	40
Witness	6	19	12	3	0	40
Enemy at the Gates	7	18	11	4	0	40
Hudsucker Proxy, The	11	11	13	3	2	40
My Best Friend's Wedding	8	16	12	3	1	40
River Wild, The	2	14	19	5	0	40
Willow	7	14	13	5	1	40
Lara Croft: Tomb Raider	3	15	10	9	3	40
Boys Don't Cry	9	17	7	3	3	39
Akira	13	17	3	2	4	39
Sideways	10	18	9	1	1	39
Hollow Man	0	9	9	13	8	39
Man on the Moon	5	17	15	1	1	39
Trading Places	8	19	10	2	0	39
Forgetting Sarah Marshall	12	17	6	3	1	39
Boogie Nights	15	19	4	1	0	39
Say Anything...	14	13	12	0	0	39
Little Shop of Horrors	2	19	14	4	0	39
Old School	11	14	10	2	2	39
Iron Giant, The	15	18	4	2	0	39
Dodgeball: A True Underdog Story	8	20	7	1	3	39
Mystery Men	5	15	7	10	2	39
Walk the Line	7	26	4	2	0	39
Last of the Mohicans, The	11	15	12	1	0	39
Burn After Reading	8	14	15	1	1	39
World Is Not Enough, The	7	13	12	5	2	39
Mean Girls	11	19	9	0	0	39
Rocketeer, The	3	12	19	5	0	39
Go	13	15	11	0	0	39
Pitch Black	4	24	8	2	1	39
French Connection, The	11	19	8	1	0	39
Indiana Jones and the Kingdom of the Crystal Skull	2	13	13	7	4	39
Old Boy	19	14	5	0	1	39
Transformers	9	13	9	7	1	39
Escape from New York	6	14	14	4	1	39
Fistful of Dollars, A (Per un pugno di dollari)	15	16	5	3	0	39
Elf	6	23	8	2	0	39
Hannibal	5	10	12	9	3	39
Dangerous Minds	3	14	15	4	2	38
Bowfinger	2	11	14	8	3	38
Notebook, The	10	16	7	3	2	38
Hero (Ying xiong)	16	14	6	2	0	38
Addams Family, The	3	14	17	3	1	38
Karate Kid, The	6	18	11	3	0	38
Bambi	5	15	15	2	1	38
Player, The	12	14	11	1	0	38
Despicable Me	9	20	7	1	1	38
Sherlock Holmes: A Game of Shadows	9	22	5	2	0	38
National Treasure	2	22	7	5	2	38
Lucky Number Slevin	11	20	6	1	0	38
Zodiac	9	18	9	1	1	38
Dog Day Afternoon	11	22	2	3	0	38
Whiplash	18	14	5	0	1	38
Specialist, The	3	10	16	7	2	38
The Machinist	14	19	3	2	0	38
Mad Max	6	18	9	5	0	38
Miracle on 34th Street	7	7	17	4	3	38
City of Lost Children, The (Cité des enfants perdus, La)	15	18	2	3	0	38
Napoleon Dynamite	7	13	11	4	2	37
Intouchables	21	9	4	2	1	37
Life Aquatic with Steve Zissou, The	10	11	12	2	2	37
Fahrenheit 9/11	3	24	7	2	1	37
Curious Case of Benjamin Button, The	8	20	7	1	1	37
Postman, The (Postino, Il)	15	14	5	3	0	37
Panic Room	3	15	11	4	4	37
My Neighbor Totoro (Tonari no Totoro)	14	18	1	3	1	37
Cool Runnings	3	7	21	6	0	37
Billy Elliot	9	23	3	1	1	37
Dune	6	19	6	4	2	37
Ransom	5	12	15	5	0	37
Free Willy	0	7	14	7	9	37
Emperor's New Groove, The	9	17	10	1	0	37
Doors, The	5	15	14	1	2	37
American Gangster	11	21	3	1	1	37
Gone Girl	8	20	6	2	1	37
Fisher King, The	12	11	11	2	0	36
Jurassic Park III	1	11	11	11	2	36
Breakfast at Tiffany's	10	18	5	2	1	36
Fantastic Four	0	10	17	6	3	36
Never Been Kissed	2	13	12	5	4	36
Thank You for Smoking	11	20	5	0	0	36
Sister Act	6	5	15	8	2	36
Rounders	11	17	7	1	0	36
Carrie	5	15	12	1	3	36
Adventures of Priscilla, Queen of the Desert, The	5	22	6	0	3	36
Mystery Science Theater 3000: The Movie	6	19	5	2	4	36
William Shakespeare's Romeo + Juliet	11	12	11	1	1	36
Swingers	9	17	5	3	2	36
From Russia with Love	8	14	14	0	0	36
Fatal Attraction	3	14	12	1	6	36
Kingsman: The Secret Service	11	21	2	1	1	36
Frequency	6	14	13	0	3	36
Brady Bunch Movie, The	0	7	20	5	4	36
Master and Commander: The Far Side of the World	8	19	7	1	1	36
Copycat	3	10	19	3	1	36
Mallrats	3	20	8	4	1	36
Robin Hood	7	11	16	1	1	36
Femme Nikita, La (Nikita)	12	19	4	0	0	35
Aviator, The	3	22	7	2	1	35
Man on Fire	10	15	4	6	0	35
Constantine	7	11	15	1	1	35
Bonnie and Clyde	12	17	6	0	0	35
Primal Fear	8	13	12	1	1	35
Quantum of Solace	5	18	10	1	1	35
Final Destination	0	15	10	7	3	35
Bull Durham	7	15	9	4	0	35
Junior	2	6	15	10	2	35
Hackers	5	6	20	3	1	35
My Fair Lady	13	17	3	1	1	35
Time to Kill, A	4	21	8	1	1	35
Incredible Hulk, The	1	17	14	2	1	35
Thin Red Line, The	10	9	6	6	4	35
Lord of War	8	19	6	1	1	35
Showgirls	1	5	11	12	6	35
Multiplicity	1	9	15	6	4	35
Kiss Kiss Bang Bang	12	20	3	0	0	35
Dumbo	4	15	11	5	0	35
What About Bob?	3	13	14	4	1	35
Coraline	11	14	7	2	1	35
Jungle Book, The	8	11	11	3	1	34
Jay and Silent Bob Strike Back	4	15	8	5	2	34
Running Man, The	5	9	13	7	0	34
Stardust	7	17	8	0	2	34
West Side Story	10	9	10	4	1	34
Anger Management	4	11	12	6	1	34
Thor	4	19	8	3	0	34
Dark Crystal, The	5	17	10	2	0	34
Wrestler, The	8	18	7	0	1	34
Lives of Others, The (Das leben der Anderen)	14	18	1	1	0	34
Matchstick Men	6	20	8	0	0	34
Harold and Kumar Go to White Castle	2	21	8	1	2	34
Stripes	9	14	10	1	0	34
Yes Man	8	15	10	0	1	34
African Queen, The	12	15	5	0	2	34
Ben-Hur	13	14	5	1	1	34
Indian in the Cupboard, The	3	12	12	5	2	34
Devil Wears Prada, The	8	17	7	0	2	34
Rudy	7	11	14	1	1	34
Tank Girl	2	11	11	6	4	34
Source Code	7	18	8	1	0	34
Evil Dead II (Dead by Dawn)	13	15	4	2	0	34
Cinema Paradiso (Nuovo cinema Paradiso)	16	13	3	0	2	34
Hurt Locker, The	15	15	3	0	1	34
Bring It On	1	9	13	7	4	34
Swordfish	1	15	13	3	2	34
Brokeback Mountain	9	13	9	3	0	34
Blade II	4	11	15	3	1	34
Ghost World	4	18	10	1	1	34
U-571	2	17	11	3	0	33
Dude, Where's My Car?	5	6	5	15	2	33
For a Few Dollars More (Per qualche dollaro in più)	13	17	3	0	0	33
Hulk	1	7	15	5	5	33
Patton	18	8	5	0	2	33
Godzilla	0	1	10	14	8	33
Underworld	5	15	13	0	0	33
Ocean's Thirteen	6	13	12	1	1	33
K-PAX	7	12	11	1	2	33
Manhattan	13	15	4	1	0	33
Heavy Metal	5	14	12	0	2	33
Like Water for Chocolate (Como agua para chocolate)	14	8	7	4	0	33
Muppet Movie, The	5	18	7	1	2	33
Tropic Thunder	8	13	8	3	1	33
Star Trek: Insurrection	3	13	11	3	3	33
Insomnia	2	13	16	1	1	33
Saw	5	14	7	3	4	33
How the Grinch Stole Christmas (a.k.a. The Grinch)	1	13	14	3	2	33
Producers, The	14	13	3	2	1	33
Punch-Drunk Love	12	9	8	3	1	33
Matilda	2	15	12	2	2	33
Dr. No	5	17	11	0	0	33
Muriel's Wedding	3	14	11	3	2	33
Pretty in Pink	3	11	13	6	0	33
Lethal Weapon 4	0	11	13	5	4	33
Long Kiss Goodnight, The	3	13	13	4	0	33
Meet the Fockers	2	15	10	4	2	33
Sgt. Bilko	3	10	11	7	2	33
Looper	8	13	9	2	0	32
The Count of Monte Cristo	9	17	4	2	0	32
Quick and the Dead, The	1	8	17	3	3	32
Zootopia	11	13	7	1	0	32
Tootsie	6	14	8	1	3	32
Iron Man 3	7	13	10	1	1	32
Up in the Air	7	17	7	1	0	32
Rosemary's Baby	14	15	2	1	0	32
Gravity	10	10	8	3	1	32
Drive	9	16	4	2	1	32
Dr. Dolittle	0	6	16	7	3	32
Out of Sight	12	11	6	2	1	32
Live Free or Die Hard	3	15	12	2	0	32
Phone Booth	1	16	10	5	0	32
Finding Neverland	4	21	4	2	1	32
To Die For	4	8	17	3	0	32
Moon	13	13	4	1	1	32
Beach, The	2	14	7	6	3	32
Team America: World Police	7	14	5	5	1	32
Captain America: The First Avenger	3	19	9	1	0	32
Bodyguard, The	1	9	12	9	1	32
Daredevil	0	6	14	10	2	32
League of Extraordinary Gentlemen, The (a.k.a. LXG)	1	7	12	9	3	32
I Know What You Did Last Summer	0	4	10	11	7	32
Dirty Dozen, The	5	23	4	0	0	32
The Lego Movie	10	15	5	0	1	31
Crazy, Stupid, Love.	7	20	4	0	0	31
Patriot Games	3	15	11	1	1	31
Roger & Me	9	15	3	3	1	31
Shallow Hal	2	11	12	5	1	31
The Revenant	13	9	8	0	1	31
Home Alone 2: Lost in New York	4	3	11	4	9	31
Madness of King George, The	10	11	7	1	2	31
Babel	4	18	7	1	1	31
Island, The	4	16	6	5	0	31
Scream 2	2	8	13	6	2	31
Captain America: The Winter Soldier	10	13	5	3	0	31
Beavis and Butt-Head Do America	3	10	6	9	3	31
Down Periscope	1	10	12	4	4	31
JFK	3	17	9	1	1	31
Bio-Dome	2	3	13	7	6	31
Wild Things	0	13	11	4	3	31
Life of Pi	8	15	4	2	2	31
Craft, The	3	5	16	7	0	31
Hercules	4	17	6	2	2	31
Pineapple Express	7	14	8	2	0	31
Conan the Barbarian	7	8	9	4	3	31
Wag the Dog	3	12	11	4	1	31
Red Dragon	8	10	9	2	2	31
Insider, The	4	20	5	2	0	31
Final Fantasy: The Spirits Within	3	16	8	4	0	31
Blind Side, The 	7	17	3	3	1	31
Rush Hour 2	3	13	13	2	0	31
City Slickers	4	11	12	3	1	31
October Sky	7	16	6	1	0	30
Limitless	11	13	6	0	0	30
Silver Linings Playbook	9	14	5	1	1	30
First Blood (Rambo: First Blood)	7	11	8	4	0	30
Emma	10	10	9	1	0	30
Under Siege 2: Dark Territory	2	6	11	6	5	30
Sabrina	7	15	6	2	0	30
Christmas Vacation (National Lampoon's Christmas Vacation)	9	11	3	7	0	30
Bullets Over Broadway	8	9	8	4	1	30
Negotiator, The	6	10	10	2	2	30
Amazing Spider-Man, The	6	11	8	2	3	30
Brave	4	15	8	2	1	30
Battle Royale (Batoru rowaiaru)	11	14	4	1	0	30
Deliverance	6	17	7	0	0	30
Manchurian Candidate, The	14	13	2	1	0	30
Fried Green Tomatoes	5	13	9	3	0	30
X-Men: Days of Future Past	10	13	6	1	0	30
Wallace & Gromit in The Curse of the Were-Rabbit	9	10	9	1	1	30
Star Trek V: The Final Frontier	1	6	11	8	4	30
Resident Evil	2	10	11	6	1	30
Sweeney Todd: The Demon Barber of Fleet Street	8	14	6	1	1	30
Saint, The	5	6	14	4	1	30
Karate Kid, Part II, The	1	8	9	9	2	29
Coyote Ugly	2	8	9	6	4	29
Frozen	8	13	5	1	2	29
Romy and Michele's High School Reunion	1	10	12	4	2	29
Sleepers	6	14	8	0	1	29
John Wick	9	14	4	1	1	29
Moonrise Kingdom	10	12	4	3	0	29
Scream 3	1	7	11	5	5	29
Hancock	2	9	13	4	1	29
Hoop Dreams	15	9	5	0	0	29
Babe: Pig in the City	4	7	7	6	5	29
Spy Hard	0	4	13	9	3	29
Easy Rider	5	16	5	2	1	29
Titan A.E.	2	13	13	1	0	29
Lost in Space	0	6	11	6	6	29
Grumpy Old Men	4	11	10	1	3	29
Rocky IV	2	6	9	7	5	29
Arsenic and Old Lace	10	14	4	0	1	29
Lilo & Stitch	7	17	4	0	1	29
Philadelphia Story, The	15	11	2	1	0	29
Dracula (Bram Stoker's Dracula)	3	14	8	4	0	29
She's All That	2	5	15	5	2	29
How to Lose a Guy in 10 Days	5	9	12	1	2	29
Deep Blue Sea	1	8	11	6	3	29
Courage Under Fire	3	12	10	2	2	29
Finding Forrester	5	15	6	2	0	28
Talladega Nights: The Ballad of Ricky Bobby	4	10	11	3	0	28
Sweet Home Alabama	3	10	7	6	2	28
Step Brothers	6	11	9	2	0	28
Night of the Living Dead	10	8	6	3	1	28
Spy Kids	2	11	9	3	3	28
Robin Hood: Prince of Thieves	1	9	11	6	1	28
Killing Fields, The	11	13	1	2	1	28
Sleeper	5	15	7	1	0	28
Mary Shelley's Frankenstein (Frankenstein)	2	8	11	4	3	28
Mighty Aphrodite	3	11	12	1	1	28
Waterboy, The	0	15	7	6	0	28
Strange Days	3	7	12	6	0	28
There Will Be Blood	15	9	3	1	0	28
Girl, Interrupted	3	14	10	1	0	28
Broadcast News	4	11	7	6	0	28
Ex Machina	16	6	3	1	2	28
Big Trouble in Little China	8	14	4	2	0	28
True Grit	8	13	5	0	2	28
Mission: Impossible III	3	17	7	1	0	28
Alice in Wonderland	1	8	12	5	2	28
Argo	12	12	2	2	0	28
Powder	3	7	12	5	1	28
Monty Python's And Now for Something Completely Different	10	14	3	1	0	28
Gods Must Be Crazy, The	9	9	9	1	0	28
Grand Day Out with Wallace and Gromit, A	14	10	2	1	1	28
Sunset Blvd. (a.k.a. Sunset Boulevard)	14	11	2	0	0	27
Grindhouse	5	11	7	3	1	27
Better Off Dead...	8	8	8	3	0	27
Prometheus	5	9	8	5	0	27
Rogue One: A Star Wars Story	11	10	4	1	1	27
Do the Right Thing	11	12	2	2	0	27
Rise of the Planet of the Apes	4	15	5	1	2	27
History of Violence, A	4	12	9	2	0	27
Forever Young	1	4	15	6	1	27
Grifters, The	6	12	5	3	1	27
Easy A	6	17	1	3	0	27
People vs. Larry Flynt, The	1	18	7	1	0	27
Princess Diaries, The	1	11	10	4	1	27
Gandhi	7	14	5	0	1	27
Wayne's World 2	3	9	12	3	0	27
Charlie's Angels: Full Throttle	0	9	6	6	6	27
Motorcycle Diaries, The (Diarios de motocicleta)	9	12	4	2	0	27
Scent of a Woman	6	12	7	1	1	27
Planes, Trains & Automobiles	9	11	6	0	1	27
Nightmare on Elm Street, A	3	9	7	6	2	27
Patch Adams	5	12	5	2	3	27
Angels in the Outfield	0	5	8	8	6	27
All the President's Men	6	20	1	0	0	27
Jerk, The	3	10	11	3	0	27
Pride & Prejudice	7	13	2	4	1	27
Apartment, The	8	14	4	0	1	27
Bedazzled	0	11	11	5	0	27
Moonstruck	5	11	7	3	1	27
Island of Dr. Moreau, The	2	4	10	10	1	27
Evolution	1	10	9	7	0	27
Guardians of the Galaxy 2	8	15	3	0	1	27
Ant-Man	6	15	5	1	0	27
Avengers: Age of Ultron	5	13	5	3	1	27
Ghost in the Shell (Kôkaku kidôtai)	11	14	2	0	0	27
Star Trek Into Darkness	8	11	5	3	0	27
Wallace & Gromit: The Best of Aardman Animation	14	8	2	1	2	27
Cube	4	14	3	4	2	27
Anaconda	1	2	4	10	10	27
Gosford Park	9	10	6	1	1	27
Die Another Day	1	9	12	2	3	27
Cloverfield	4	9	10	4	0	27
Spy Game	2	13	11	1	0	27
Halloween	8	7	10	2	0	27
Buffy the Vampire Slayer	0	4	11	7	4	26
Naked Gun 2 1/2: The Smell of Fear, The	4	10	9	3	0	26
Lost Boys, The	6	12	6	1	1	26
In & Out	0	9	8	5	4	26
Moonraker	3	9	8	4	2	26
Harold and Maude	14	9	3	0	0	26
Scary Movie 2	2	4	11	6	3	26
Private Parts	5	11	7	3	0	26
Dick Tracy	2	7	9	5	3	26
13th Warrior, The	2	7	11	3	3	26
Moneyball	8	14	3	0	1	26
Cider House Rules, The	6	13	6	0	1	26
Spawn	1	7	7	7	4	26
Mighty Ducks, The	0	6	10	7	3	26
Rocky II	3	8	10	3	2	26
Birdman: Or (The Unexpected Virtue of Ignorance)	6	9	7	2	2	26
Jacob's Ladder	5	13	4	2	2	26
¡Three Amigos!	2	9	10	4	1	26
The Hunger Games: Catching Fire	5	15	5	0	1	26
Death Proof	4	12	4	2	4	26
21 Jump Street	9	10	6	1	0	26
Bad Santa	5	12	5	2	2	26
Airheads	1	6	10	7	2	26
X-Men Origins: Wolverine	0	11	10	3	2	26
Muppet Treasure Island	4	7	12	2	1	26
Transporter, The	2	17	4	3	0	26
National Lampoon's Vacation	5	13	6	2	0	26
Arrival	8	13	5	0	0	26
Roman Holiday	11	9	6	0	0	26
Big Short, The	11	8	7	0	0	26
Waking Ned Devine (a.k.a. Waking Ned)	3	17	4	1	1	26
Last Emperor, The	4	14	7	0	1	26
Virgin Suicides, The	7	11	6	2	0	26
Pay It Forward	6	10	8	0	2	26
Village, The	4	8	9	4	1	26
About Schmidt	3	12	6	2	3	26
RoboCop 2	2	5	9	4	5	25
Prince of Egypt, The	6	6	11	2	0	25
Sword in the Stone, The	3	13	8	1	0	25
House of Flying Daggers (Shi mian mai fu)	2	17	5	1	0	25
Dangerous Liaisons	8	13	2	1	1	25
Man in the Iron Mask, The	4	10	9	2	0	25
Lemony Snicket's A Series of Unfortunate Events	1	13	6	5	0	25
Dial M for Murder	7	16	2	0	0	25
Shooter	7	12	6	0	0	25
Excalibur	7	8	8	2	0	25
28 Days	3	8	11	3	0	25
Richie Rich	1	3	10	2	9	25
What Lies Beneath	3	8	8	6	0	25
Sliding Doors	6	10	8	0	1	25
Girl with the Dragon Tattoo, The (Män som hatar kvinnor)	9	10	4	2	0	25
Hobbit: The Desolation of Smaug, The	6	11	5	2	1	25
3:10 to Yuma	10	12	2	1	0	25
Secretary	10	11	3	1	0	25
In the Name of the Father	11	12	2	0	0	25
Serendipity	4	7	10	2	2	25
Day the Earth Stood Still, The	5	13	7	0	0	25
1408	1	14	6	1	3	25
Bone Collector, The	0	11	7	2	5	25
Teenage Mutant Ninja Turtles	1	11	6	4	3	25
Pushing Tin	0	9	7	6	3	25
Big Chill, The	6	11	7	1	0	25
21 Grams	2	11	10	1	1	25
Midnight in Paris	5	11	7	2	0	25
Young Guns	1	10	9	3	2	25
Pee-wee's Big Adventure	1	10	6	3	5	25
Logan	13	10	2	0	0	25
Superman Returns	3	6	14	0	2	25
Her	10	8	5	2	0	25
Event Horizon	2	8	5	9	1	25
King Kong	6	9	7	3	0	25
Modern Times	5	14	5	0	1	25
Cape Fear	5	13	7	0	0	25
Strangers on a Train	8	12	4	0	1	25
Natural, The	3	13	7	1	0	24
L.A. Story	3	9	9	3	0	24
Remains of the Day, The	4	11	6	2	1	24
Dr. Horrible's Sing-Along Blog	9	11	3	0	1	24
Holiday, The	4	10	6	2	2	24
Van Helsing	1	3	12	8	0	24
Under Siege	2	4	11	5	2	24
Scrooged	4	5	11	2	2	24
All About Eve	12	10	1	0	1	24
Bulworth	4	8	7	2	3	24
Pirates of the Caribbean: On Stranger Tides	2	13	4	4	1	24
Flight of the Navigator	0	11	10	2	1	24
Rocky III	1	6	7	8	2	24
Horrible Bosses	4	12	6	1	1	24
Dante's Peak	1	4	8	9	2	24
Secret Garden, The	2	8	12	1	1	24
Waiting for Guffman	7	10	6	1	0	24
Return of the Pink Panther, The	3	15	4	1	1	24
Tangled	9	11	1	3	0	24
Mad Max Beyond Thunderdome	2	10	7	5	0	24
National Treasure: Book of Secrets	0	12	7	4	1	24
Laputa: Castle in the Sky (Tenkû no shiro Rapyuta)	10	11	2	1	0	24
Before Sunrise	10	10	2	1	1	24
Tarzan	5	7	9	3	0	24
Three Colors: Blue (Trois couleurs: Bleu)	12	8	1	1	2	24
Super Troopers	6	8	8	1	1	24
Logan's Run	0	11	9	4	0	24
Freaky Friday	0	12	9	3	0	24
Little Nicky	0	5	12	4	3	24
xXx	0	9	9	3	3	24
Coming to America	3	11	9	1	0	24
Thunderball	3	10	10	1	0	24
Fletch	3	6	10	3	2	24
Desperately Seeking Susan	0	3	13	6	2	24
Sandlot, The	4	10	7	2	1	24
Midnight in the Garden of Good and Evil	5	4	6	7	2	24
Little Big Man	12	9	1	1	1	24
On the Waterfront	13	8	2	0	1	24
Crocodile Dundee II	2	3	9	3	7	24
Lawnmower Man, The	0	7	9	5	3	24
Along Came Polly	2	9	8	4	1	24
Bedknobs and Broomsticks	5	7	9	3	0	24
Third Man, The	14	6	3	0	1	24
Shine	7	14	2	0	1	24
Dolores Claiborne	2	8	13	1	0	24
Mickey Blue Eyes	0	10	7	5	1	23
Driving Miss Daisy	5	13	3	1	1	23
Frighteners, The	1	14	6	1	1	23
Fighter, The	4	14	3	2	0	23
Mexican, The	2	9	10	2	0	23
The Hunger Games: Mockingjay - Part 1	5	15	3	0	0	23
Nausicaä of the Valley of the Wind (Kaze no tani no Naushika)	12	7	3	0	1	23
Bound	6	13	3	1	0	23
Blast from the Past	1	8	10	3	1	23
Duck Soup	7	10	3	2	1	23
Welcome to the Dollhouse	4	9	8	2	0	23
Backdraft	3	9	6	4	1	23
Good bye, Lenin!	8	8	6	1	0	23
American Werewolf in London, An	2	12	6	2	1	23
Bottle Rocket	8	9	4	1	1	23
Faculty, The	0	5	8	7	3	23
Stigmata	1	8	6	6	2	23
Michael	1	4	9	5	4	23
Bridges of Madison County, The	2	7	12	1	1	23
Hocus Pocus	1	5	9	5	3	23
Ice Age 2: The Meltdown	1	13	6	2	1	23
Space Cowboys	0	7	11	4	1	23
Family Man, The	2	7	11	0	3	23
Sphere	0	8	7	6	2	23
Live and Let Die	5	9	9	0	0	23
Sex, Lies, and Videotape	7	8	5	1	2	23
Jurassic World	0	15	5	2	1	23
Capote	7	14	1	1	0	23
To Catch a Thief	9	12	1	1	0	23
Night at the Museum	1	10	10	1	1	23
U.S. Marshals	2	6	10	3	2	23
Click	3	6	10	2	2	23
Elizabeth	5	11	4	3	0	23
Chronicles of Riddick, The	3	10	7	2	1	23
Amores Perros (Love's a Bitch)	7	11	3	2	0	23
Pink Floyd: The Wall	6	10	5	1	1	23
Mission: Impossible - Ghost Protocol	4	11	6	1	0	22
Milk Money	2	5	12	3	0	22
Forget Paris	2	9	8	1	2	22
Twilight	2	2	7	7	4	22
Triplets of Belleville, The (Les triplettes de Belleville)	4	12	6	0	0	22
Network	9	10	1	1	1	22
Scanner Darkly, A	4	12	5	0	1	22
25th Hour	4	14	4	0	0	22
To Wong Foo, Thanks for Everything! Julie Newmar	3	6	13	0	0	22
Englishman Who Went Up a Hill But Came Down a Mountain, The	2	8	8	4	0	22
Arrival, The	1	8	8	4	1	22
Mr. Deeds	1	4	12	5	0	22
Hoosiers (a.k.a. Best Shot)	3	15	3	0	1	22
Wonder Boys	4	12	4	2	0	22
The Scorpion King	0	3	9	5	5	22
Strictly Ballroom	7	7	5	1	2	22
Drop Zone	1	4	11	3	3	22
Wedding Planner, The	1	6	10	4	1	22
National Lampoon's Van Wilder	2	4	10	6	0	22
Right Stuff, The	6	11	3	1	1	22
White Men Can't Jump	1	8	6	6	1	22
Omen, The	6	9	7	0	0	22
Time Machine, The	2	3	10	7	0	22
Doctor Strange	7	8	5	2	0	22
Captain America: Civil War	5	9	7	1	0	22
Evil Dead, The	7	9	5	1	0	22
G.I. Jane	0	6	10	4	2	22
Midnight Cowboy	8	8	4	2	0	22
Terms of Endearment	6	8	6	2	0	22
Town, The	5	16	1	0	0	22
Awakenings	2	14	5	1	0	22
Midnight Run	3	11	7	1	0	22
River Runs Through It, A	8	8	6	0	0	22
Sleeping Beauty	0	11	10	1	0	22
Weird Science	1	8	10	2	1	22
Man of Steel	2	8	11	1	0	22
Now You See Me	4	11	1	5	1	22
Working Girl	2	6	11	3	0	22
Identity	5	11	5	1	0	22
Police Academy	2	8	7	3	2	22
Wreck-It Ralph	5	13	2	2	0	22
Simple Plan, A	5	11	4	2	0	22
Wanted	3	7	8	4	0	22
Cabin in the Woods, The	11	6	3	2	0	22
Planet Terror	8	8	5	0	1	22
eXistenZ	6	12	3	1	0	22
Superman III	0	3	7	8	4	22
Arlington Road	1	10	8	2	1	22
Snowpiercer	5	8	5	2	1	21
Heavenly Creatures	6	9	6	0	0	21
Delicatessen	4	13	3	1	0	21
Munich	7	9	4	1	0	21
28 Weeks Later	4	13	1	3	0	21
RoboCop 3	1	3	4	9	4	21
Timecop	0	5	6	7	3	21
Super Mario Bros.	0	1	6	8	6	21
Poseidon Adventure, The	1	9	7	2	2	21
13 Going on 30	2	5	13	1	0	21
Metropolis	4	12	5	0	0	21
Adjustment Bureau, The	3	6	10	1	1	21
Mulholland Falls	1	4	10	4	2	21
WarGames	1	10	8	2	0	21
Keeping the Faith	2	13	3	3	0	21
Zack and Miri Make a Porno	4	12	2	3	0	21
Jewel of the Nile, The	0	5	11	3	2	21
For Your Eyes Only	4	9	6	1	1	21
Paper, The	1	7	12	0	1	21
Little Princess, A	4	13	4	0	0	21
Wyatt Earp	2	5	8	5	1	21
Shrek the Third	2	7	7	3	2	21
First Wives Club, The	2	7	6	5	1	21
Adventures of Buckaroo Banzai Across the 8th Dimension, The	6	3	10	2	0	21
Mission to Mars	0	6	9	4	2	21
Help, The	4	14	3	0	0	21
Ted	3	10	4	4	0	21
Joe Dirt	0	2	10	6	3	21
Secret of NIMH, The	1	12	7	1	0	21
View to a Kill, A	2	7	9	3	0	21
Charlotte's Web	4	8	7	1	1	21
Money Pit, The	2	3	11	3	2	21
We're the Millers	5	11	4	1	0	21
Other Guys, The	3	9	4	4	1	21
Aeon Flux	1	6	8	5	1	21
Bridesmaids	5	11	3	2	0	21
Predator 2	2	5	8	4	2	21
Darjeeling Limited, The	2	10	8	1	0	21
Ever After: A Cinderella Story	6	7	7	1	0	21
Diamonds Are Forever	2	9	10	0	0	21
Captain Phillips	8	9	4	0	0	21
2012	0	7	5	6	3	21
Super 8	6	8	5	2	0	21
Inspector Gadget	1	1	6	7	6	21
Thor: The Dark World	1	13	5	2	0	21
I Heart Huckabees	5	10	3	2	1	21
And Your Mother Too (Y tu mamá también)	7	10	3	1	0	21
Broken Flowers	2	11	8	0	0	21
Walk in the Clouds, A	4	7	7	3	0	21
Reality Bites	1	5	7	5	3	21
Ghost and the Darkness, The	4	8	6	3	0	21
Boiler Room	1	15	4	1	0	21
Starsky & Hutch	1	9	9	2	0	21
Doctor Zhivago	7	11	3	0	0	21
Weekend at Bernie's	1	3	9	6	2	21
Repo Man	3	10	3	5	0	21
Déjà Vu (Deja Vu)	2	10	5	3	0	20
Miller's Crossing	9	9	2	0	0	20
Being There	8	5	7	0	0	20
Real Genius	3	10	6	1	0	20
Transformers: Revenge of the Fallen	0	5	6	5	4	20
Friends with Benefits	1	9	8	0	2	20
Score, The	1	12	6	1	0	20
Cowboy Bebop: The Movie (Cowboy Bebop: Tengoku no Tobira)	8	10	1	1	0	20
Bridget Jones: The Edge of Reason	1	7	8	3	1	20
George of the Jungle	1	7	8	3	1	20
Role Models	2	14	2	2	0	20
Girl Next Door, The	2	10	4	2	2	20
Anastasia	2	7	10	1	0	20
Dogville	10	7	2	1	0	20
Short Circuit	2	8	8	1	1	20
Dawn of the Dead	9	6	3	2	0	20
Beverly Hillbillies, The	2	3	8	4	3	20
6th Day, The	0	6	8	5	1	20
Pitch Perfect	3	13	2	2	0	20
Wall Street	4	11	4	1	0	20
Major League	3	10	6	1	0	20
Perks of Being a Wallflower, The	6	9	3	2	0	20
Licence to Kill	4	4	8	4	0	20
Downfall (Untergang, Der)	7	10	2	0	1	20
Holes	1	14	4	1	0	20
Solaris	2	8	6	2	2	20
27 Dresses	2	7	10	0	1	20
Thor: Ragnarok	11	5	3	0	1	20
Bill & Ted's Bogus Journey	1	5	10	4	0	20
Four Rooms	4	9	5	2	0	20
Meet Joe Black	2	10	3	1	4	20
Gone Baby Gone	2	11	5	0	2	20
Three Colors: White (Trzy kolory: Bialy)	6	12	1	1	0	20
Dancer in the Dark	7	10	1	2	0	20
Last King of Scotland, The	8	9	2	0	1	20
Oblivion	4	7	4	5	0	20
Toys	0	2	10	4	4	20
Great Gatsby, The	4	6	9	1	0	20
Peacemaker, The	3	3	9	3	2	20
Intolerable Cruelty	2	7	8	2	1	20
First Strike (Police Story 4: First Strike) (Ging chaat goo si 4: Ji gaan daan yam mo)	2	11	5	2	0	20
Barb Wire	3	2	5	6	4	20
Animatrix, The	6	9	4	1	0	20
Notorious	7	12	1	0	0	20
Dirty Harry	3	13	4	0	0	20
Megamind	5	10	2	3	0	20
Fantastic Four: Rise of the Silver Surfer	0	3	11	5	1	20
Adventures in Babysitting	3	7	8	1	1	20
Red	3	10	5	2	0	20
Scary Movie 3	2	2	6	6	4	20
From Hell	4	9	6	1	0	20
Friday	5	9	5	1	0	20
Homeward Bound: The Incredible Journey	0	9	5	5	1	20
Shallow Grave	6	6	6	0	2	20
Good Night, and Good Luck.	5	11	4	0	0	20
Behind Enemy Lines	0	10	9	0	1	20
Fox and the Hound, The	3	10	6	1	0	20
Secret Life of Walter Mitty, The	8	8	4	0	0	20
Brothers Grimm, The	0	4	11	2	3	20
Honey, I Blew Up the Kid	0	1	6	8	5	20
Streetcar Named Desire, A	13	5	2	0	0	20
Kids	7	9	4	0	0	20
Phantom, The	1	3	10	2	3	19
Blood Simple	8	6	5	0	0	19
Speed 2: Cruise Control	0	0	3	7	9	19
Virtuosity	1	4	6	7	1	19
Ray	2	14	1	2	0	19
Benny & Joon	4	6	7	1	1	19
Stuart Little	1	2	12	2	2	19
Grease 2	0	1	9	3	6	19
22 Jump Street	4	10	3	2	0	19
Beverly Hills Cop II	0	6	8	4	1	19
High Noon	9	7	3	0	0	19
Henry V	6	10	2	1	0	19
Atlantis: The Lost Empire	4	3	11	1	0	19
Soylent Green	0	10	9	0	0	19
Days of Thunder	1	6	5	3	4	19
Three Men and a Baby	1	6	7	4	1	19
2 Fast 2 Furious (Fast and the Furious 2, The)	0	3	11	4	1	19
Muppet Christmas Carol, The	6	5	8	0	0	19
Waking Life	7	6	3	2	1	19
Spotlight	11	6	2	0	0	19
Ghost Dog: The Way of the Samurai	8	7	3	1	0	19
All About My Mother (Todo sobre mi madre)	9	8	1	0	1	19
Despicable Me 2	4	11	1	2	1	19
World War Z	0	9	5	5	0	19
Lone Star	9	7	1	2	0	19
Jack	1	6	8	4	0	19
Apocalypto	3	10	5	1	0	19
Dracula: Dead and Loving It	1	3	6	3	6	19
Tron: Legacy	1	10	4	4	0	19
One Hour Photo	3	9	6	0	1	19
Robots	1	8	7	2	1	19
Professional, The (Le professionnel)	5	11	2	1	0	19
Kalifornia	1	6	9	3	0	19
Kung Fu Hustle (Gong fu)	5	9	3	0	2	19
Cloud Atlas	4	9	6	0	0	19
Maid in Manhattan	1	5	7	3	3	19
Star Trek: Nemesis	1	6	10	1	1	19
Rambo: First Blood Part II	1	4	6	5	3	19
Two Weeks Notice	1	9	7	2	0	19
Eastern Promises	7	10	1	1	0	19
Layer Cake	4	12	3	0	0	19
Shanghai Knights	1	7	9	2	0	19
Battlefield Earth	1	1	1	6	10	19
EDtv	0	7	7	5	0	19
Replacements, The	0	4	10	4	1	19
Shaft	0	7	3	7	2	19
Hard Day's Night, A	2	8	7	2	0	19
Battlestar Galactica	7	8	2	0	2	19
Double Jeopardy	2	6	7	2	2	19
Nurse Betty	1	7	10	1	0	19
50/50	2	12	5	0	0	19
Airplane II: The Sequel	4	4	5	5	1	19
Red Violin, The (Violon rouge, Le)	5	11	3	0	0	19
Amistad	2	10	6	0	1	19
The Hateful Eight	5	7	6	0	0	18
Hugo	4	10	4	0	0	18
Man with the Golden Gun, The	3	8	6	1	0	18
Hellboy II: The Golden Army	3	13	2	0	0	18
March of the Penguins (Marche de l'empereur, La)	3	10	5	0	0	18
Ladyhawke	0	10	5	3	0	18
Bourne Legacy, The	1	7	7	3	0	18
Seabiscuit	2	13	3	0	0	18
Clue	1	6	11	0	0	18
Boyz N the Hood	4	10	3	1	0	18
Hustler, The	11	5	2	0	0	18
127 Hours	5	10	1	2	0	18
American Tail, An	4	4	4	6	0	18
Smoke	7	3	5	2	1	18
Rebecca	9	6	3	0	0	18
Jumper	1	6	8	3	0	18
Monster's Ball	2	10	4	0	2	18
World's End, The	5	7	2	2	2	18
America's Sweethearts	1	3	8	4	2	18
Nightcrawler	9	7	2	0	0	18
American Splendor	8	4	5	1	0	18
Romeo Must Die	1	5	9	3	0	18
Bronx Tale, A	4	7	7	0	0	18
The Man from U.N.C.L.E.	4	8	3	3	0	18
Rashomon (Rashômon)	7	9	1	0	1	18
Fantastic Mr. Fox	9	6	2	1	0	18
Once Upon a Time in the West (C'era una volta il West)	11	5	2	0	0	18
We Were Soldiers	3	8	3	3	1	18
40 Days and 40 Nights	1	6	9	1	1	18
Idiocracy	6	8	2	1	1	18
Men in Black III (M.III.B.) (M.I.B.³)	1	10	5	1	1	18
Reign of Fire	0	5	7	5	1	18
Seventh Seal, The (Sjunde inseglet, Det)	8	8	2	0	0	18
Ref, The	4	4	7	3	0	18
Bolt	2	8	7	1	0	18
Spy Who Loved Me, The	2	9	5	1	1	18
Renaissance Man	2	3	8	5	0	18
Rat Race	2	5	7	4	0	18
Small Soldiers	0	6	6	5	1	18
Shadow, The	0	4	9	5	0	18
Beneath the Planet of the Apes	2	3	5	6	2	18
Jingle All the Way	1	6	6	2	3	18
Westworld	0	8	10	0	0	18
Immortal Beloved	3	9	4	2	0	18
Tucker & Dale vs Evil	6	9	2	1	0	18
8MM	0	7	7	3	1	18
Sliver	0	2	11	2	3	18
Popeye	0	3	8	4	3	18
The Hobbit: The Battle of the Five Armies	4	5	7	1	1	18
Outlaw Josey Wales, The	7	9	2	0	0	18
21	3	12	2	1	0	18
I Still Know What You Did Last Summer	1	1	3	7	6	18
Mariachi, El	2	9	6	1	0	18
Nixon	3	9	6	0	0	18
Any Given Sunday	0	7	7	3	1	18
Name of the Rose, The (Name der Rose, Der)	4	10	3	1	0	18
Dead Men Don't Wear Plaid	2	7	4	5	0	18
Golden Compass, The	1	7	8	1	1	18
Sky Captain and the World of Tomorrow	0	7	4	5	2	18
Divergent	2	6	6	2	2	18
Terminator Salvation	1	9	6	2	0	18
Jackal, The	2	6	6	3	1	18
Stir of Echoes	1	11	4	2	0	18
Crimes and Misdemeanors	4	12	1	1	0	18
Bringing Up Baby	6	6	5	0	1	18
Look Who's Talking	1	3	5	5	4	18
Mr. Smith Goes to Washington	9	6	2	1	0	18
Blade Runner 2049	7	7	3	0	1	18
The Theory of Everything	5	8	2	2	0	17
20,000 Leagues Under the Sea	3	5	7	2	0	17
Michael Clayton	6	8	2	1	0	17
Serpico	3	10	3	1	0	17
Double Indemnity	8	8	1	0	0	17
Along Came a Spider	1	5	9	2	0	17
Man Who Wasn't There, The	4	7	6	0	0	17
Boyhood	7	7	2	0	1	17
2010: The Year We Make Contact	1	11	4	1	0	17
Kindergarten Cop	0	7	8	0	2	17
Falling Down	4	6	3	4	0	17
Bob Roberts	1	5	10	1	0	17
'burbs, The	3	6	3	3	2	17
10,000 BC	0	4	8	4	1	17
Lost Highway	4	6	2	4	1	17
Man Who Would Be King, The	6	8	3	0	0	17
Mission: Impossible - Rogue Nation	4	9	2	1	1	17
Man Without a Face, The	3	3	8	2	1	17
Something's Gotta Give	3	9	4	1	0	17
Major Payne	2	5	5	2	3	17
Goofy Movie, A	3	2	8	2	2	17
Jarhead	2	11	3	1	0	17
City of Angels	3	5	7	2	0	17
Rango	5	7	3	2	0	17
Deuce Bigalow: Male Gigolo	0	4	5	2	6	17
Rocky V	0	0	5	8	4	17
Kingdom of Heaven	3	8	4	2	0	17
Blades of Glory	1	7	7	1	1	17
Corrina, Corrina	1	6	6	4	0	17
Kate & Leopold	2	7	5	2	1	17
Juror, The	1	5	2	7	2	17
I Am Sam	5	9	2	0	1	17
Houseguest	2	4	7	4	0	17
Scooby-Doo	3	2	7	3	2	17
Ice Storm, The	6	5	5	1	0	17
Jaws 2	1	2	7	5	2	17
It Could Happen to You	0	5	10	2	0	17
Kiki's Delivery Service (Majo no takkyûbin)	7	8	1	1	0	17
Exit to Eden	0	3	6	6	2	17
Lara Croft Tomb Raider: The Cradle of Life	1	3	7	5	1	17
Let the Right One In (Låt den rätte komma in)	6	8	2	1	0	17
Letters from Iwo Jima	3	10	4	0	0	17
Miracle on 34th Street	8	6	3	0	0	17
A-Team, The	0	7	9	1	0	17
Primer	4	9	3	1	0	17
Monster	2	10	4	0	1	17
Paycheck	1	5	7	4	0	17
Maltese Falcon, The (a.k.a. Dangerous Female)	4	8	3	1	1	17
Of Mice and Men	3	9	4	1	0	17
I Love You, Man	1	11	4	1	0	17
On Her Majesty's Secret Service	2	7	5	3	0	17
Touch of Evil	9	6	2	0	0	17
Recruit, The	3	7	5	2	0	17
Bad Boys II	2	5	4	5	1	17
Room with a View, A	4	10	1	1	1	17
Cloudy with a Chance of Meatballs	4	6	5	2	0	17
Angels & Demons	2	7	6	1	1	17
Universal Soldier	1	1	7	3	5	17
Dallas Buyers Club	7	8	1	0	1	17
Match Point	1	10	5	0	1	17
Kung Fu Panda 2	2	8	4	2	1	17
Runaway Jury	0	11	6	0	0	17
Sum of All Fears, The	0	8	4	5	0	17
Big Momma's House	0	2	6	5	4	17
Mighty Morphin Power Rangers: The Movie	0	3	6	2	6	17
Expendables, The	1	6	6	4	0	17
Cinderella Man	4	13	0	0	0	17
Elephant Man, The	4	11	2	0	0	17
AVP: Alien vs. Predator	3	2	5	6	1	17
Shaolin Soccer (Siu lam juk kau)	5	8	4	0	0	17
Conversation, The	7	8	2	0	0	17
Dictator, The	4	8	1	4	0	17
Chain Reaction	0	5	7	4	1	17
Rundown, The	1	6	9	1	0	17
Enchanted	3	10	4	0	0	17
Crumb	7	9	1	0	0	17
Jackass: The Movie	2	11	2	1	1	17
What's Love Got to Do with It?	0	9	7	1	0	17
Spectre	4	4	5	1	3	17
Underworld: Evolution	2	3	9	2	0	16
Hamlet	6	6	3	1	0	16
Magnificent Seven, The	2	9	4	0	1	16
Book of Eli, The	1	11	2	2	0	16
Untitled Spider-Man Reboot	6	9	1	0	0	16
Point Break	1	6	8	0	1	16
Beverly Hills Ninja	0	5	3	5	3	16
Grave of the Fireflies (Hotaru no haka)	7	7	2	0	0	16
Wolf	3	2	8	3	0	16
Rosencrantz and Guildenstern Are Dead	7	4	4	0	1	16
Happiness	8	6	1	1	0	16
Three Colors: Red (Trois couleurs: Rouge)	10	4	1	0	1	16
History of the World: Part I	4	5	6	1	0	16
Serial Mom	0	3	11	2	0	16
Three Days of the Condor (3 Days of the Condor)	3	9	3	0	1	16
Secret of Roan Inish, The	3	7	6	0	0	16
Little Rascals, The	1	3	5	5	2	16
Assassins	2	5	5	3	1	16
Vicky Cristina Barcelona	2	4	7	1	2	16
Batman v Superman: Dawn of Justice	1	2	4	8	1	16
Transporter 2	0	8	7	1	0	16
F/X	1	3	11	1	0	16
Flashdance	1	4	6	4	1	16
Bean	1	4	7	3	1	16
Cop Land	2	5	6	3	0	16
Imaginarium of Doctor Parnassus, The	4	9	3	0	0	16
Flubber	1	5	6	4	0	16
Nosferatu (Nosferatu, eine Symphonie des Grauens)	1	9	5	1	0	16
American Hustle	1	9	3	2	1	16
Proposal, The	4	5	6	1	0	16
Footloose	1	5	8	1	1	16
Hurricane, The	2	8	5	1	0	16
Up Close and Personal	2	6	8	0	0	16
Boomerang	0	2	9	4	1	16
Dirty Rotten Scoundrels	5	10	1	0	0	16
Circle of Friends	4	8	2	0	2	16
Friday the 13th	3	2	4	5	2	16
Ender's Game	3	7	4	2	0	16
12 Years a Slave	1	11	3	1	0	16
Nutty Professor II: The Klumps	1	1	4	8	2	16
Half Baked	3	8	3	2	0	16
Dawn of the Dead	7	6	2	0	1	16
Another Stakeout	0	1	8	6	1	16
Howard the Duck	1	1	4	5	5	16
Outsiders, The	3	8	5	0	0	16
Prisoners	9	3	3	1	0	16
Treasure of the Sierra Madre, The	4	6	5	0	1	16
Spy	4	8	3	0	1	16
Legend of Drunken Master, The (Jui kuen II)	8	3	5	0	0	16
Back to School	0	5	7	3	1	16
Bicycle Thieves (a.k.a. The Bicycle Thief) (a.k.a. The Bicycle Thieves) (Ladri di biciclette)	10	3	2	0	1	16
Once Upon a Time in America	6	6	4	0	0	16
Tremors	3	6	5	1	1	16
Maleficent	1	6	5	0	4	16
Black Sheep	2	6	4	3	1	16
Wolverine, The	2	7	5	2	0	16
Closer	1	13	1	1	0	16
Six Days Seven Nights	0	3	10	2	1	16
Perfect Murder, A	1	7	5	3	0	16
Superman IV: The Quest for Peace	0	0	1	10	5	16
St. Elmo's Fire	2	5	7	1	1	16
Sweet Hereafter, The	7	7	2	0	0	16
Annie	4	2	7	2	1	16
Elysium	1	9	5	1	0	16
Very Bad Things	3	6	4	2	1	16
Get Smart	2	7	7	0	0	16
Maze Runner, The	1	6	6	1	2	16
Syriana	2	8	6	0	0	16
Monsters University	5	7	4	0	0	16
American Wedding (American Pie 3)	1	7	5	3	0	16
Golden Child, The	0	5	5	4	2	16
Frida	2	11	3	0	0	16
Sudden Death	2	2	9	3	0	16
Save the Last Dance	2	3	7	2	2	16
Hot Tub Time Machine	1	9	2	3	0	15
Ran	7	8	0	0	0	15
Romeo and Juliet	3	7	5	0	0	15
Star Trek Beyond	2	8	5	0	0	15
Minions	3	6	3	1	2	15
Amityville Horror, The	2	1	5	5	2	15
Richard III	2	8	5	0	0	15
Gremlins 2: The New Batch	1	6	6	2	0	15
Screamers	3	5	4	2	1	15
Hellraiser	2	6	5	1	1	15
End of Days	0	7	1	4	3	15
Rebel Without a Cause	5	8	2	0	0	15
Parent Trap, The	1	4	8	2	0	15
How to Train Your Dragon 2	6	4	5	0	0	15
Glengarry Glen Ross	3	6	4	2	0	15
Basketball Diaries, The	2	7	5	1	0	15
Adventureland	2	6	5	2	0	15
Everyone Says I Love You	3	4	7	1	0	15
European Vacation (aka National Lampoon's European Vacation)	0	0	11	4	0	15
Pete's Dragon	0	3	6	6	0	15
Bicentennial Man	1	3	6	3	2	15
Malcolm X	4	10	1	0	0	15
Lord of the Rings, The	2	4	5	4	0	15
Dead Zone, The	4	6	4	1	0	15
All Dogs Go to Heaven	1	2	7	4	1	15
About Time	6	7	1	1	0	15
Snake Eyes	1	2	6	5	1	15
White Squall	4	7	4	0	0	15
Dawn of the Planet of the Apes	3	6	3	3	0	15
Age of Innocence, The	3	5	4	3	0	15
Summer of Sam	2	8	2	2	1	15
Can't Hardly Wait	2	6	4	3	0	15
Fantasia 2000	3	8	4	0	0	15
Ninth Gate, The	1	8	1	5	0	15
Crow: City of Angels, The	2	2	6	3	2	15
Commitments, The	3	9	2	1	0	15
Encino Man	0	2	5	7	1	15
Muppets Take Manhattan, The	2	5	6	1	1	15
Dead Man	8	5	1	0	1	15
General's Daughter, The	0	6	5	3	1	15
Hangover Part II, The	1	9	3	1	1	15
Hot Shots!	1	5	7	2	0	15
Get Out	5	3	6	1	0	15
The Nice Guys	4	8	2	1	0	15
Money Train	0	5	2	6	2	15
Short Cuts	4	3	4	2	2	15
Zero Effect	4	8	3	0	0	15
Hairspray	0	12	2	1	0	15
Devil's Own, The	1	4	6	1	3	15
Paul	2	6	5	1	1	15
Volcano	0	0	4	10	1	15
Seven Psychopaths	2	7	5	1	0	15
Before Sunset	4	7	2	1	1	15
American Sniper	4	8	2	1	0	15
Hours, The	5	6	3	0	1	15
Confessions of a Dangerous Mind	2	9	4	0	0	15
Varsity Blues	2	6	3	4	0	15
Salt	0	7	5	3	0	15
Jumpin' Jack Flash	0	3	4	7	1	15
Fallen	2	6	5	2	0	15
Odd Couple, The	3	11	1	0	0	15
Secret Window	1	7	6	0	1	15
Orange County	0	2	10	2	1	15
Escape from the Planet of the Apes	1	5	4	4	1	15
Kelly's Heroes	6	7	2	0	0	15
Mr. Mom	1	1	8	4	1	15
Legend of Bagger Vance, The	1	5	7	1	1	15
EuroTrip	3	3	6	2	1	15
You Don't Mess with the Zohan	1	3	7	2	2	15
Parenthood	3	6	5	1	0	15
Idle Hands	0	3	5	6	1	15
How to Make an American Quilt	2	4	5	2	2	15
Out of Africa	2	8	5	0	0	15
Great Dictator, The	7	6	2	0	0	15
Flatliners	0	4	8	3	0	15
Death Becomes Her	1	2	8	4	0	15
M	3	9	1	1	1	15
Next Karate Kid, The	1	0	6	5	3	15
Blade: Trinity	1	3	7	2	1	14
Not Another Teen Movie	0	5	5	1	3	14
Zero Dark Thirty	5	8	1	0	0	14
Nutty Professor, The	1	1	7	2	3	14
Blue Lagoon, The	0	3	3	6	2	14
Sicko	1	11	2	0	0	14
Manhattan Murder Mystery	3	7	3	1	0	14
10 Cloverfield Lane	2	7	5	0	0	14
9	2	9	2	1	0	14
Papillon	2	11	1	0	0	14
His Girl Friday	7	7	0	0	0	14
Number 23, The	0	5	7	1	1	14
Dredd	4	6	2	2	0	14
Dinosaur	1	2	10	1	0	14
Surrogates	2	3	6	2	1	14
Diner	4	4	6	0	0	14
Kramer vs. Kramer	3	9	2	0	0	14
Ice Age: Dawn of the Dinosaurs	0	6	3	1	4	14
Fantastic Beasts and Where to Find Them	3	8	2	1	0	14
Teenage Mutant Ninja Turtles III	0	1	7	1	5	14
Ladykillers, The	1	4	5	1	3	14
Replacement Killers, The	0	4	6	4	0	14
Karate Kid, Part III, The	0	0	2	8	4	14
Just Cause	3	2	8	1	0	14
Big Sleep, The	7	5	1	1	0	14
Definitely, Maybe	2	7	4	1	0	14
Vertical Limit	0	3	5	5	1	14
Mamma Mia!	1	5	6	1	1	14
Over the Hedge	2	8	2	2	0	14
Officer and a Gentleman, An	4	5	4	0	1	14
1984 (Nineteen Eighty-Four)	3	6	4	1	0	14
No Strings Attached	0	6	6	1	1	14
Punisher, The	3	4	5	2	0	14
Seven Years in Tibet	2	4	7	1	0	14
Twins	0	1	8	4	1	14
Ruthless People	1	6	4	3	0	14
Porco Rosso (Crimson Pig) (Kurenai no buta)	5	8	0	1	0	14
Mist, The	4	4	4	0	2	14
What Dreams May Come	3	6	4	1	0	14
Nacho Libre	0	4	4	4	2	14
Bubba Ho-tep	0	9	4	1	0	14
Snakes on a Plane	1	3	5	2	3	14
Straight Story, The	2	11	1	0	0	14
Resident Evil: Apocalypse	1	3	4	6	0	14
King Kong	1	1	7	4	1	14
In the Mood For Love (Fa yeung nin wa)	8	4	2	0	0	14
Talk to Her (Hable con Ella)	4	10	0	0	0	14
Red Dawn	3	5	3	2	1	14
This Is the End	2	5	5	2	0	14
Barton Fink	6	7	1	0	0	14
Phantasm	2	3	3	4	2	14
House on Haunted Hill	0	3	5	4	2	14
Walk to Remember, A	4	5	3	1	1	14
8 1/2 (8½)	7	4	3	0	0	14
Yellow Submarine	1	5	6	2	0	14
Brotherhood of the Wolf (Pacte des loups, Le)	5	5	4	0	0	14
Rocky Balboa	2	5	5	2	0	14
Sunshine	3	5	6	0	0	14
Whale Rider	4	6	3	0	1	14
Creepshow	1	4	5	4	0	14
Clockers	1	4	5	3	1	14
Limey, The	3	9	2	0	0	14
Pacific Rim	4	7	1	1	1	14
Marley & Me	1	7	3	2	1	14
It Happened One Night	7	5	2	0	0	14
Accepted	0	6	6	1	1	14
One, The	0	6	4	2	2	14
Pollock	2	5	7	0	0	14
Devil in a Blue Dress	1	4	8	1	0	14
Once Were Warriors	5	5	4	0	0	14
Shadowlands	2	6	5	1	0	14
Eat Drink Man Woman (Yin shi nan nu)	6	5	0	3	0	14
Mighty Wind, A	3	7	4	0	0	14
In Time	1	9	3	1	0	14
Sister Act 2: Back in the Habit	0	1	2	7	4	14
Fountain, The	2	7	4	1	0	14
Saved!	3	8	3	0	0	14
Boys on the Side	2	5	4	3	0	14
Cape Fear	3	10	1	0	0	14
Lucy	0	4	7	2	1	14
City Hall	0	1	10	2	1	14
Sexy Beast	2	9	2	1	0	14
Homeward Bound II: Lost in San Francisco	1	7	5	1	0	14
Son in Law	1	4	3	4	2	14
BASEketball	0	7	4	3	0	14
X-Men: Apocalypse	2	5	3	3	1	14
Crank	4	2	6	2	0	14
S.W.A.T.	0	10	3	1	0	14
Men of Honor	1	6	5	2	0	14
Once Upon a Time in Mexico	1	4	8	1	0	14
Next	1	6	3	2	2	14
Nobody's Fool	3	5	6	0	0	14
Warm Bodies	2	7	4	1	0	14
Things to Do in Denver When You're Dead	1	3	8	2	0	14
Uncle Buck	0	6	4	2	1	13
Spellbound	5	6	1	1	0	13
Yojimbo	8	3	1	0	1	13
Perfect World, A	0	6	6	1	0	13
Ninja Scroll (Jûbei ninpûchô)	4	6	2	1	0	13
Orgazmo	1	6	4	1	1	13
No Man's Land	5	7	1	0	0	13
Siege, The	0	4	5	3	1	13
Thirteen Days	2	9	2	0	0	13
Fog of War: Eleven Lessons from the Life of Robert S. McNamara, The	7	6	0	0	0	13
Alien Nation	2	2	6	2	1	13
Mercury Rising	0	6	3	4	0	13
Postman, The	2	2	3	5	1	13
Passion of the Christ, The	1	4	5	0	3	13
Teenage Mutant Ninja Turtles II: The Secret of the Ooze	0	4	4	4	1	13
Turner & Hooch	0	6	4	3	0	13
Cutthroat Island	1	5	2	4	1	13
Avengers: Infinity War - Part I	7	3	1	2	0	13
The Queen	1	10	0	2	0	13
Twelfth Night	1	6	6	0	0	13
Suicide Kings	2	4	7	0	0	13
Misérables, Les	0	8	4	1	0	13
Starman	0	6	5	1	1	13
Heaven Can Wait	0	5	7	1	0	13
Chariots of Fire	4	6	3	0	0	13
Lord of the Flies	0	6	2	5	0	13
Charade	2	8	3	0	0	13
Dreamers, The	2	8	3	0	0	13
Don't Tell Mom the Babysitter's Dead	0	2	6	2	3	13
Legend	0	6	4	3	0	13
Invasion of the Body Snatchers	2	7	4	0	0	13
Wonder Woman	3	5	2	3	0	13
Spartacus	2	6	5	0	0	13
Born on the Fourth of July	0	10	2	1	0	13
King Arthur	2	2	5	3	1	13
Empire Records	3	3	5	2	0	13
Bewitched	0	0	8	4	1	13
Exit Through the Gift Shop	5	7	1	0	0	13
Breakdown	1	6	4	1	1	13
Shall We Dance? (Shall We Dansu?)	2	9	1	1	0	13
Enter the Dragon	4	8	1	0	0	13
Road to El Dorado, The	1	6	2	4	0	13
Fly Away Home	1	6	6	0	0	13
Last Man Standing	0	1	6	5	1	13
Fly, The	0	6	6	1	0	13
Barcelona	4	4	2	3	0	13
Living in Oblivion	5	8	0	0	0	13
Texas Chainsaw Massacre, The	2	6	2	1	2	13
Reindeer Games	1	1	3	7	1	13
Saw II	1	4	5	1	2	13
Color of Money, The	1	6	5	1	0	13
Shark Tale	0	2	6	3	2	13
Prince of Persia: The Sands of Time	0	5	5	2	1	13
Johnny English	2	5	3	1	2	13
Rescuers, The	1	4	6	1	1	13
Madagascar: Escape 2 Africa	3	6	4	0	0	13
Winnie the Pooh and the Blustery Day	4	3	5	1	0	13
City Lights	6	3	2	2	0	13
Atonement	3	6	3	1	0	13
Crocodile Dundee in Los Angeles	0	4	2	3	4	13
RocknRolla	3	7	3	0	0	13
The Intern	3	7	2	0	1	13
Aladdin and the King of Thieves	1	6	2	3	1	13
Bank Job, The	3	6	3	1	0	13
Wings of Desire (Himmel über Berlin, Der)	4	6	2	0	1	13
Clash of the Titans	0	1	7	2	3	13
Fury	3	7	2	1	0	13
Purple Rose of Cairo, The	4	5	2	2	0	13
Adventures of Baron Munchausen, The	5	3	4	1	0	13
Ultraviolet	0	1	5	3	4	13
Tao of Steve, The	1	7	4	0	1	13
Constant Gardener, The	2	5	6	0	0	13
Bucket List, The	1	5	6	1	0	13
Inconvenient Truth, An	2	6	5	0	0	13
Coco	5	3	1	4	0	13
Father of the Bride	2	7	2	1	1	13
On Golden Pond	3	7	1	1	1	13
Private Benjamin	0	3	9	1	0	13
Metropolis	5	6	2	0	0	13
Haunting, The	0	0	5	6	2	13
Marie Antoinette	0	6	6	0	1	13
Evan Almighty	1	1	8	1	2	13
Murder in the First	5	4	4	0	0	13
Dunkirk	2	6	3	2	0	13
Clerks II	2	10	1	0	0	13
Red Planet	0	2	4	6	1	13
Pelican Brief, The	0	3	7	3	0	13
Tequila Sunrise	0	2	10	1	0	13
Mothman Prophecies, The	1	2	9	1	0	13
Kiss the Girls	2	2	6	2	1	13
Waiting...	2	4	4	3	0	13
Forbidden Planet	2	9	1	1	0	13
Mimic	0	2	6	3	2	13
Guns of Navarone, The	1	8	4	0	0	13
Godzilla	0	4	4	4	1	13
Othello	0	8	5	0	0	13
Finding Dory	3	5	4	1	0	13
Hannah and Her Sisters	5	6	0	2	0	13
Marathon Man	1	7	4	1	0	13
Revenge of the Nerds	0	4	5	4	0	13
Dead Again	4	3	6	0	0	13
Pacific Heights	1	4	5	3	0	13
Batman: Mask of the Phantasm	6	5	2	0	0	13
Gift, The	0	3	8	1	1	13
Harold & Kumar Escape from Guantanamo Bay	0	8	4	1	0	13
Fatal Instinct	0	3	7	1	1	12
Absolute Power	0	2	6	3	1	12
Victor/Victoria	2	6	2	2	0	12
Where the Wild Things Are	1	2	6	1	2	12
Silent Hill	1	4	4	2	1	12
Rambo III	0	0	2	7	3	12
Rainmaker, The	1	6	4	1	0	12
Flintstones in Viva Rock Vegas, The	0	0	1	6	5	12
Exotica	0	6	6	0	0	12
Menace II Society	1	7	4	0	0	12
Howards End	4	5	3	0	0	12
Father of the Bride	2	4	4	1	1	12
Opposite of Sex, The	1	4	4	2	1	12
Flirting With Disaster	3	5	2	1	1	12
Celebration, The (Festen)	9	2	1	0	0	12
Machete	1	4	5	2	0	12
Secondhand Lions	1	7	4	0	0	12
Dungeons & Dragons	0	0	4	4	4	12
Kids in the Hall: Brain Candy	2	4	4	1	1	12
Princess and the Frog, The	3	8	0	1	0	12
King and I, The	5	6	1	0	0	12
Brothers McMullen, The	1	5	4	2	0	12
Children of a Lesser God	3	5	4	0	0	12
Good Girl, The	1	5	4	2	0	12
Ordinary People	4	5	3	0	0	12
Lake Placid	0	2	6	3	1	12
Girl with a Pearl Earring	1	6	4	1	0	12
Blind Swordsman: Zatoichi, The (Zatôichi)	2	9	1	0	0	12
Nightmare on Elm Street 3: Dream Warriors, A	0	4	5	2	1	12
Boxing Helena	0	3	4	2	3	12
Small Time Crooks	2	4	5	1	0	12
Borrowers, The	0	3	7	2	0	12
Igby Goes Down	4	4	2	2	0	12
Stepford Wives, The	0	0	8	2	2	12
A Million Ways to Die in the West	0	7	3	0	2	12
Child's Play	0	2	5	5	0	12
The Interview	3	5	3	0	1	12
Cookie's Fortune	3	6	2	1	0	12
Fright Night	2	5	4	0	1	12
Police Academy 2: Their First Assignment	1	2	3	3	3	12
American in Paris, An	1	8	3	0	0	12
King of Kong, The	3	7	2	0	0	12
400 Blows, The (Les quatre cents coups)	3	8	0	1	0	12
SLC Punk!	3	6	2	1	0	12
Village of the Damned	1	2	6	2	1	12
Deadpool 2	5	4	2	0	1	12
Highlander III: The Sorcerer (a.k.a. Highlander: The Final Dimension)	0	0	8	2	2	12
Station Agent, The	1	8	2	1	0	12
Jack Reacher	1	6	4	1	0	12
Eragon	1	0	7	2	2	12
Ugly Truth, The	1	8	3	0	0	12
Cold Mountain	2	5	3	2	0	12
Kazaam	1	1	4	1	5	12
Monsoon Wedding	4	6	0	1	1	12
Married to the Mob	0	3	7	1	1	12
Fracture	4	5	2	1	0	12
Single White Female	1	5	5	1	0	12
Rise of the Guardians	4	4	4	0	0	12
Chronicles of Narnia: Prince Caspian, The	0	8	4	0	0	12
Living Daylights, The	1	4	6	1	0	12
War of the Worlds, The	1	4	4	3	0	12
Daylight	1	2	3	5	1	12
Black Beauty	0	4	7	1	0	12
2 Days in the Valley	0	4	5	3	0	12
Six Degrees of Separation	3	3	5	1	0	12
Family Guy Presents Stewie Griffin: The Untold Story	1	9	2	0	0	12
Dirty Pretty Things	2	7	3	0	0	12
Prophecy, The	2	5	3	2	0	12
Dead Calm	0	5	5	1	1	12
Thirteenth Floor, The	0	5	5	0	2	12
Around the World in 80 Days	2	5	5	0	0	12
Sirens	0	4	7	0	1	12
State and Main	4	4	4	0	0	12
Ong-Bak: The Thai Warrior (Ong Bak)	4	7	1	0	0	12
Contagion	1	9	2	0	0	12
Heartbreak Ridge	2	5	5	0	0	12
Star Wars: The Last Jedi	4	3	1	2	2	12
Evita	3	4	2	3	0	12
Memoirs of a Geisha	1	9	2	0	0	12
Manchurian Candidate, The	0	5	6	1	0	12
Parent Trap, The	1	3	6	2	0	12
Rookie, The	1	5	4	2	0	12
Goodbye Girl, The	2	6	4	0	0	12
Wes Craven's New Nightmare (Nightmare on Elm Street Part 7: Freddy's Finale, A)	2	1	5	3	1	12
Inside Job	7	4	0	1	0	12
You Only Live Twice	2	8	2	0	0	12
Tales from the Crypt Presents: Bordello of Blood	1	1	4	5	1	12
Sydney (Hard Eight)	0	7	5	0	0	12
Color Purple, The	3	6	3	0	0	12
Cyrano de Bergerac	4	6	2	0	0	12
Creature Comforts	6	6	0	0	0	12
Blues Brothers 2000	1	2	4	4	1	12
Suicide Squad	0	4	6	1	1	12
Fools Rush In	1	5	4	1	1	12
Proof of Life	0	5	5	1	1	12
Ghost Rider	0	1	5	4	2	12
Paths of Glory	8	4	0	0	0	12
Cutting Edge, The	0	6	2	2	2	12
Adventures of Tintin, The	1	8	3	0	0	12
Phantom of the Opera, The	1	5	4	1	1	12
Sucker Punch	0	7	2	3	0	12
Buffalo '66 (a.k.a. Buffalo 66)	3	3	4	0	2	12
Innerspace	0	4	7	0	1	12
Beauty of the Day (Belle de jour)	2	7	3	0	0	12
Down to Earth	0	2	5	3	2	12
Brick	5	5	1	1	0	12
Thirteen Ghosts (a.k.a. Thir13en Ghosts)	0	1	7	3	1	12
Everything You Always Wanted to Know About Sex * But Were Afraid to Ask	1	6	4	0	1	12
Problem Child	0	0	3	3	6	12
Julie & Julia	1	5	3	1	2	12
Shoot 'Em Up	2	5	4	1	0	12
Harvey	4	5	2	0	1	12
Dukes of Hazzard, The	0	0	5	5	2	12
Hard Candy	5	3	2	1	1	12
Conquest of the Planet of the Apes	1	2	4	4	1	12
Scary Movie 4	1	1	3	5	2	12
Neighbors	0	7	4	1	0	12
Malice	0	3	6	3	0	12
The Amazing Spider-Man 2	0	3	4	3	1	11
Polar Express, The	2	2	5	1	1	11
Porky's	1	1	1	5	3	11
He's Just Not That Into You	0	4	4	2	1	11
Hidalgo	0	5	6	0	0	11
Badlands	5	4	2	0	0	11
Ponyo (Gake no ue no Ponyo)	5	3	2	1	0	11
Bedtime Stories	0	7	3	1	0	11
Valkyrie	0	7	4	0	0	11
Seven Pounds	4	7	0	0	0	11
Croupier	2	7	2	0	0	11
Kid, The	1	2	3	3	2	11
Body of Lies	2	7	2	0	0	11
Milk	1	7	2	1	0	11
Saving Grace	4	4	3	0	0	11
Autumn in New York	2	0	2	5	2	11
Spanglish	0	7	3	1	0	11
Chorus, The (Choristes, Les)	5	4	2	0	0	11
Pink Panther, The	0	7	4	0	0	11
Beethoven	0	1	2	3	5	11
In Good Company	1	5	5	0	0	11
Roxanne	0	6	4	1	0	11
Wedding Date, The	1	5	4	0	1	11
Far from Heaven	3	7	1	0	0	11
Made in America	0	0	10	1	0	11
Saturday Night Fever	1	6	3	1	0	11
Now You See Me 2	2	7	1	0	1	11
Strange Brew	4	1	5	1	0	11
Das Experiment (Experiment, The)	4	4	3	0	0	11
Wild Bunch, The	3	4	3	1	0	11
Persuasion	7	3	1	0	0	11
All Dogs Go to Heaven 2	1	3	6	0	1	11
Diabolique	1	1	5	2	2	11
Substitute, The	0	2	8	0	1	11
Oliver & Company	1	2	6	2	0	11
Thinner	0	4	4	1	2	11
Harriet the Spy	1	3	5	2	0	11
39 Steps, The	4	6	0	1	0	11
Michael Collins	0	6	3	2	0	11
Big Night	4	6	1	0	0	11
When a Man Loves a Woman	3	4	4	0	0	11
Secrets & Lies	7	4	0	0	0	11
Bananas	2	3	4	2	0	11
Sicario	2	6	2	1	0	11
The Jungle Book	2	6	2	1	0	11
Jean de Florette	3	7	1	0	0	11
Cook the Thief His Wife & Her Lover, The	0	6	3	0	2	11
Frailty	3	5	3	0	0	11
Thin Blue Line, The	3	7	1	0	0	11
Cheech and Chong's Up in Smoke	3	4	2	1	1	11
Big Blue, The (Grand bleu, Le)	3	2	5	1	0	11
Killer, The (Die xue shuang xiong)	4	6	0	0	1	11
Flightplan	0	4	4	3	0	11
Down by Law	3	6	2	0	0	11
Koyaanisqatsi (a.k.a. Koyaanisqatsi: Life Out of Balance)	3	5	3	0	0	11
Unbearable Lightness of Being, The	2	3	3	2	1	11
Death to Smoochy	2	3	5	1	0	11
Candyman	0	3	3	3	2	11
Young Guns II	2	2	2	4	1	11
Descent, The	1	6	4	0	0	11
Black Panther	4	4	1	2	0	11
Queen of the Damned	0	0	7	3	1	11
Jungle2Jungle (a.k.a. Jungle 2 Jungle)	0	1	3	5	2	11
Smilla's Sense of Snow	0	5	6	0	0	11
Crash	2	5	1	0	3	11
John Q	0	4	5	2	0	11
Fun with Dick and Jane	0	0	7	2	2	11
Hostel	1	2	5	1	2	11
Edge, The	0	4	4	3	0	11
48 Hrs.	2	5	3	1	0	11
Horrible Bosses 2	1	8	1	1	0	11
Great Expectations	1	5	3	2	0	11
Primary Colors	1	5	5	0	0	11
Spanish Prisoner, The	3	6	2	0	0	11
Ocean's Eleven (a.k.a. Ocean's 11)	3	5	1	2	0	11
Benchwarmers, The	0	3	6	1	1	11
From Here to Eternity	2	7	2	0	0	11
Legally Blonde 2: Red, White & Blonde	0	2	5	2	2	11
In the Heat of the Night	3	8	0	0	0	11
Take the Money and Run	2	4	4	0	1	11
Dumb and Dumberer: When Harry Met Lloyd	1	0	3	4	3	11
Break-Up, The	0	4	2	4	1	11
Fast and the Furious: Tokyo Drift, The (Fast and the Furious 3, The)	0	0	5	4	2	11
Anchorman 2: The Legend Continues	1	6	3	1	0	11
Rush	2	7	2	0	0	11
Children of the Corn	0	4	2	2	3	11
Kick-Ass 2	1	4	6	0	0	11
Witches of Eastwick, The	1	3	2	3	2	11
Doctor Dolittle	3	4	3	1	0	11
Avengers, The	0	1	3	6	1	11
Red Rock West	2	3	6	0	0	11
Science of Sleep, The (La science des rêves)	3	8	0	0	0	11
My Blue Heaven	2	1	5	3	0	11
Flags of Our Fathers	2	6	2	0	1	11
Saw III	2	2	5	1	1	11
Happy Feet	1	3	4	1	2	11
Stepford Wives, The	0	4	6	1	0	11
Hedwig and the Angry Inch	7	2	1	1	0	11
Hotel Transylvania	2	6	1	2	0	11
Young Sherlock Holmes	0	4	7	0	0	11
Civil Action, A	0	3	6	2	0	11
Cocktail	0	5	3	2	1	11
Meet the Robinsons	1	7	2	1	0	11
How the Grinch Stole Christmas!	2	6	2	1	0	11
John Carter	0	7	1	2	1	11
This Means War	0	5	1	4	1	11
William Shakespeare's A Midsummer Night's Dream	1	1	8	1	0	11
Cats & Dogs	0	3	5	2	1	11
Frankenstein	4	5	1	1	0	11
Dr. Dolittle 2	0	1	5	4	1	11
Descendants, The	4	6	1	0	0	11
Animal, The	0	0	5	5	1	11
Funny Farm	0	3	3	4	1	11
The Artist	7	2	1	0	1	11
Warrior	3	4	4	0	0	11
Canadian Bacon	1	2	3	5	0	11
Medicine Man	2	3	2	4	0	11
Astronaut's Wife, The	0	1	4	4	2	11
I Now Pronounce You Chuck and Larry	2	5	3	0	1	11
Mississippi Burning	0	9	2	0	0	11
Bulletproof Monk	0	2	4	4	1	11
Across the Universe	3	6	2	0	0	11
Transformers: Dark of the Moon	0	3	3	3	2	11
High Plains Drifter	3	7	1	0	0	11
Nine to Five (a.k.a. 9 to 5)	1	1	4	5	0	11
Hairspray	1	4	4	2	0	11
Hanna	1	7	2	0	1	11
Chitty Chitty Bang Bang	2	4	4	1	0	11
Bachelor, The	1	2	3	2	3	11
30 Days of Night	1	2	7	1	0	11
Green Hornet, The	0	4	5	1	1	11
Persepolis	5	6	0	0	0	11
Mister Roberts	2	5	4	0	0	11
Messenger: The Story of Joan of Arc, The	4	3	4	0	0	11
Longest Day, The	2	8	1	0	0	11
Ringu (Ring)	2	5	3	1	0	11
Saving Silverman (Evil Woman)	0	2	7	2	0	11
P.S. I Love You	1	5	2	2	1	11
My Dog Skip	1	7	3	0	0	11
Date Night	0	7	4	0	0	11
Far and Away	1	3	6	1	0	11
Singles	1	5	1	4	0	11
Twin Peaks: Fire Walk with Me	1	4	6	0	0	11
Stop! Or My Mom Will Shoot	0	0	3	3	5	11
Breaking Away	3	7	1	0	0	11
Harry and the Hendersons	1	1	3	5	1	11
Shadow of the Vampire	1	2	7	1	0	11
Great Muppet Caper, The	1	4	5	1	0	11
Guess Who's Coming to Dinner	8	2	1	0	0	11
Baby Mama	2	3	4	1	1	11
Fall, The	4	5	1	1	0	11
Serious Man, A	2	3	5	0	1	11
Solaris (Solyaris)	6	3	1	1	0	11
Sex and the City	0	2	7	0	2	11
Mona Lisa Smile	0	4	3	2	1	10
Mosquito Coast, The	0	4	6	0	0	10
Street Fighter	1	1	3	4	1	10
Expendables 2, The	1	5	4	0	0	10
Drop Dead Gorgeous	0	4	5	1	0	10
Body Heat	2	6	2	0	0	10
Ideal Husband, An	1	6	2	1	0	10
9 1/2 Weeks (Nine 1/2 Weeks)	0	1	6	2	1	10
Louis C.K.: Live at the Beacon Theater	7	2	0	0	1	10
Drunken Master (Jui kuen)	4	3	3	0	0	10
Fast Five (Fast and the Furious 5, The)	1	5	2	0	2	10
House Bunny, The	0	3	3	3	1	10
Cannonball Run, The	1	2	3	2	2	10
Disturbia	1	3	6	0	0	10
Open Your Eyes (Abre los ojos)	2	5	3	0	0	10
Stuck on You	0	4	4	0	2	10
Freddy Got Fingered	0	1	4	3	2	10
Night Shift	1	2	4	3	0	10
Christine	0	4	4	0	2	10
Pet Sematary	1	2	3	3	1	10
Music and Lyrics	0	6	3	0	1	10
Smokin' Aces	2	1	5	2	0	10
Resident Evil: Extinction	0	4	5	1	0	10
Cooler, The	0	8	2	0	0	10
Hunt, The (Jagten)	4	6	0	0	0	10
Police Academy 3: Back in Training	1	0	4	2	3	10
Lincoln Lawyer, The	2	5	2	1	0	10
Pink Flamingos	0	3	4	1	2	10
Heartbreakers	0	0	5	3	2	10
Fahrenheit 451	3	4	3	0	0	10
Re-Animator	2	5	2	0	1	10
Drugstore Cowboy	4	5	0	1	0	10
Night at the Roxbury, A	0	2	1	4	3	10
Assassination of Jesse James by the Coward Robert Ford, The	5	2	3	0	0	10
Urban Legend	0	1	4	5	0	10
Hate (Haine, La)	4	3	3	0	0	10
Elite Squad (Tropa de Elite)	5	5	0	0	0	10
Beautiful Girls	1	8	1	0	0	10
Internship, The	1	7	1	0	1	10
Bee Movie	0	5	5	0	0	10
Women on the Verge of a Nervous Breakdown (Mujeres al borde de un ataque de nervios)	3	3	3	0	1	10
Little Man Tate	1	3	5	1	0	10
Eraserhead	2	5	3	0	0	10
Rope	2	8	0	0	0	10
It's a Mad, Mad, Mad, Mad World	1	3	5	1	0	10
Down with Love	0	4	4	1	1	10
Miracle	1	4	4	1	0	10
Be Kind Rewind	1	5	3	1	0	10
American Tail: Fievel Goes West, An	0	2	5	2	1	10
Due Date	1	5	2	2	0	10
Watership Down	3	6	1	0	0	10
Nick of Time	0	5	4	1	0	10
15 Minutes	2	3	1	3	1	10
Miami Vice	0	3	3	4	0	10
Free Willy 2: The Adventure Home	0	1	5	2	2	10
Man with Two Brains, The	0	4	5	1	0	10
Something Wicked This Way Comes	1	1	5	3	0	10
Rescuers Down Under, The	1	4	5	0	0	10
Swimming with Sharks	2	4	2	2	0	10
Futurama: Bender's Big Score	2	6	2	0	0	10
Lake House, The	2	1	5	1	1	10
Devil's Backbone, The (Espinazo del diablo, El)	1	5	3	0	1	10
In the Bedroom	0	5	2	2	1	10
Jury Duty	2	1	2	3	2	10
Nightmare on Elm Street 2: Freddy's Revenge, A	0	1	4	3	2	10
Fast & Furious (Fast and the Furious 4, The)	0	4	5	1	0	10
All Quiet on the Western Front	6	4	0	0	0	10
Tales from the Crypt Presents: Demon Knight	2	3	1	4	0	10
Misérables, Les	3	3	4	0	0	10
Spice World	0	0	2	2	6	10
Predestination	4	4	1	1	0	10
Majestic, The	2	4	3	1	0	10
Sorcerer's Apprentice, The	1	6	2	1	0	10
Grown Ups	2	4	3	1	0	10
Predators	0	7	3	0	0	10
Twilight Saga: Eclipse, The	0	2	4	2	2	10
Hidden Figures	2	6	1	1	0	10
17 Again	1	7	2	0	0	10
Wild Tales	6	3	1	0	0	10
Joy Luck Club, The	2	4	3	1	0	10
Get Him to the Greek	2	6	1	1	0	10
Chappie	1	4	4	1	0	10
Addicted to Love	0	3	3	3	1	10
Empire of the Sun	4	4	1	1	0	10
Haunted Mansion, The	0	3	2	5	0	10
Girl Who Leapt Through Time, The (Toki o kakeru shôjo)	5	3	2	0	0	10
Rent	0	4	5	1	0	10
Showtime	0	2	4	3	1	10
Focus	2	3	4	0	1	10
Final Fantasy VII: Advent Children	2	4	3	1	0	10
Some Kind of Wonderful	2	2	4	2	0	10
Dead Alive (Braindead)	6	2	1	0	1	10
Trainwreck	1	5	3	0	1	10
The Hunger Games: Mockingjay - Part 2	1	8	0	1	0	10
Doom	0	2	1	4	3	10
My Left Foot	2	6	2	0	0	10
Italian Job, The	3	5	2	0	0	10
Sweetest Thing, The	0	5	3	1	1	10
Semi-Pro	0	3	5	2	0	10
When We Were Kings	3	4	3	0	0	10
Sophie's Choice	5	2	3	0	0	10
Salton Sea, The	1	4	5	0	0	10
Kid in King Arthur's Court, A	0	2	4	2	2	10
Aristocrats, The	3	2	3	1	1	10
Swiss Family Robinson	1	5	3	1	0	10
Apple Dumpling Gang, The	0	2	3	5	0	10
Importance of Being Earnest, The	3	4	3	0	0	10
Cat on a Hot Tin Roof	5	3	2	0	0	10
Key Largo	5	4	1	0	0	10
Meet Me in St. Louis	3	6	1	0	0	10
Defending Your Life	3	3	4	0	0	10
Very Brady Sequel, A	1	3	4	2	0	10
Night at the Museum: Battle of the Smithsonian	0	5	4	0	1	10
Alexander	0	1	5	1	3	10
Brüno (Bruno)	3	4	2	1	0	10
Sherlock: The Abominable Bride	4	4	1	0	1	10
Cold Comfort Farm	1	4	5	0	0	10
Flipper	1	2	4	3	0	10
Top Secret!	3	7	0	0	0	10
One Fine Day	1	1	7	0	1	10
Tuxedo, The	1	1	4	1	3	10
Something to Talk About	1	4	1	4	0	10
Hostage	0	3	6	1	0	10
Hard Target	0	2	5	3	0	10
Elektra	0	1	3	4	2	10
Moana	2	5	1	1	1	10
Spring, Summer, Fall, Winter... and Spring (Bom yeoreum gaeul gyeoul geurigo bom)	5	5	0	0	0	10
Loser	2	4	0	4	0	10
Mary and Max	5	4	1	0	0	10
My Girl	1	2	6	1	0	10
Blown Away	0	1	7	2	0	10
Skulls, The	1	0	6	2	1	10
Corporation, The	1	8	1	0	0	10
Final Destination 2	0	3	6	1	0	10
Grudge, The	0	0	5	5	0	10
Nick and Norah's Infinite Playlist	2	4	3	0	1	10
Arthur	1	1	3	5	0	10
Ip Man	3	6	0	1	0	10
Battleship Potemkin	2	6	1	0	1	10
Eight Men Out	1	6	3	0	0	10
Sommersby	0	2	6	2	0	10
Change-Up, The	0	5	2	2	1	10
American Werewolf in Paris, An	0	2	2	4	2	10
Throw Momma from the Train	0	6	2	1	1	10
Detroit Rock City	1	4	1	2	2	10
Firestarter	0	4	3	3	0	10
Green Lantern	0	3	2	3	2	10
Muppets, The	1	3	1	3	2	10
Gung Ho	0	4	3	2	0	9
Dan in Real Life	1	3	5	0	0	9
Red Sonja	0	1	3	3	2	9
Fletch Lives	1	1	0	5	2	9
Freaks	0	3	6	0	0	9
Anna and the King	3	3	2	1	0	9
Ghost Ship	0	3	3	1	2	9
Higher Learning	0	0	6	3	0	9
Smoke Signals	0	7	0	1	1	9
Your Highness	2	1	4	2	0	9
Teaching Mrs. Tingle	1	2	0	4	2	9
Twilight Saga: New Moon, The	0	2	4	3	0	9
New Guy, The	0	2	4	2	1	9
Antwone Fisher	1	5	3	0	0	9
Tenacious D in The Pick of Destiny	0	6	3	0	0	9
UHF	1	6	1	0	1	9
Freddy vs. Jason	0	1	4	3	1	9
Me Myself I	0	6	3	0	0	9
Ready to Wear (Pret-A-Porter)	1	1	5	0	2	9
Old Yeller	0	6	2	1	0	9
General, The	4	3	1	1	0	9
Cowboys & Aliens	0	3	4	2	0	9
Collateral Damage	0	1	6	2	0	9
Unstrung Heroes	0	3	5	1	0	9
Love Bug, The	0	3	4	2	0	9
Apt Pupil	1	1	6	1	0	9
Knowing	0	1	7	1	0	9
Farewell My Concubine (Ba wang bie ji)	4	3	1	0	1	9
Stuart Saves His Family	0	0	1	3	5	9
Escape to Witch Mountain	0	3	4	2	0	9
Stalag 17	1	6	2	0	0	9
Open Range	3	6	0	0	0	9
Bloodsport	1	2	3	3	0	9
Hellbound: Hellraiser II	2	2	3	1	1	9
Croods, The	2	5	2	0	0	9
Prizzi's Honor	2	3	4	0	0	9
Frost/Nixon	1	8	0	0	0	9
Producers, The	1	4	3	1	0	9
Public Enemies	0	4	4	0	1	9
Gettysburg	2	3	4	0	0	9
About Last Night...	0	1	7	1	0	9
Meatballs	2	2	2	2	1	9
Cops and Robbersons	0	0	3	5	1	9
Undercover Brother	0	1	1	4	3	9
Bubble Boy	0	0	2	6	1	9
Lawnmower Man 2: Beyond Cyberspace	0	1	5	1	2	9
Simon Birch	0	4	4	0	1	9
Adventures of Rocky and Bullwinkle, The	0	2	2	2	3	9
Terminator Genisys	0	2	4	2	1	9
Absent-Minded Professor, The	0	5	4	0	0	9
Spellbound	2	4	3	0	0	9
Never Cry Wolf	3	5	1	0	0	9
Grapes of Wrath, The	3	6	0	0	0	9
My Favorite Year	1	3	4	1	0	9
Man Who Knew Too Much, The	2	4	2	1	0	9
Baby Driver	6	2	1	0	0	9
Mission, The	1	4	3	1	0	9
Species II	0	0	4	2	3	9
Infernal Affairs (Mou gaan dou)	4	5	0	0	0	9
Irreversible (Irréversible)	2	6	1	0	0	9
Supercop (Police Story 3: Supercop) (Jing cha gu shi III: Chao ji jing cha)	2	5	1	1	0	9
Longest Yard, The	1	2	6	0	0	9
Unleashed (Danny the Dog)	1	5	3	0	0	9
Joe's Apartment	0	2	3	3	1	9
How High	1	4	0	3	1	9
Stand and Deliver	1	4	4	0	0	9
Bad Teacher	1	4	1	2	1	9
Fled	0	2	0	7	0	9
Supergirl	1	0	1	5	2	9
16 Blocks	0	2	7	0	0	9
Bad News Bears, The	1	4	3	1	0	9
Rambo (Rambo 4)	0	5	3	1	0	9
Vampire Hunter D: Bloodlust (Banpaia hantâ D)	0	6	1	1	1	9
House of Sand and Fog	2	5	2	0	0	9
Little Shop of Horrors, The	0	2	5	2	0	9
Gothika	1	3	4	0	1	9
Catwoman	0	0	0	5	4	9
Narc	0	5	4	0	0	9
My Fellow Americans	0	2	3	3	1	9
No Way Out	2	3	4	0	0	9
102 Dalmatians	1	1	4	3	0	9
Operation Dumbo Drop	0	1	3	4	1	9
Some Folks Call It a Sling Blade	1	7	1	0	0	9
Barbarella	1	4	1	2	1	9
Weather Man, The	1	5	2	0	1	9
Once	2	6	1	0	0	9
Thirteen	1	6	2	0	0	9
Killing, The	2	6	1	0	0	9
Squid and the Whale, The	1	5	2	1	0	9
Clash of the Titans	2	3	4	0	0	9
Muppets From Space	1	3	3	1	1	9
La La Land	1	5	2	0	1	9
Smokey and the Bandit	0	3	3	2	1	9
Hand That Rocks the Cradle, The	0	2	6	1	0	9
Alive	1	2	4	2	0	9
Monty Python Live at the Hollywood Bowl	2	7	0	0	0	9
MirrorMask	2	4	3	0	0	9
Paprika (Papurika)	3	2	4	0	0	9
My Life as a Dog (Mitt liv som hund)	4	4	1	0	0	9
Pride and Prejudice	4	2	1	1	1	9
Now and Then	3	0	4	2	0	9
Life as a House	3	4	1	1	0	9
Blue Streak	0	1	4	4	0	9
My Life in Pink (Ma vie en rose)	4	2	3	0	0	9
Witness for the Prosecution	5	4	0	0	0	9
Raise the Red Lantern (Da hong deng long gao gao gua)	4	5	0	0	0	9
World According to Garp, The	0	6	2	1	0	9
Dracula	0	6	3	0	0	9
House	1	3	1	4	0	9
Kiss of the Dragon	1	7	1	0	0	9
Gladiator	6	2	1	0	0	9
Pump Up the Volume	1	4	4	0	0	9
Louis C.K.: Hilarious	5	3	0	0	1	9
Black Cat, White Cat (Crna macka, beli macor)	4	3	0	2	0	9
It	1	4	3	0	1	9
Green Card	0	4	3	1	1	9
Green Street Hooligans (a.k.a. Hooligans)	2	5	2	0	0	9
Pitch Perfect 2	1	4	4	0	0	9
Monster House	0	5	3	0	1	9
Lion in Winter, The	2	5	2	0	0	9
The Raid: Redemption	5	3	1	0	0	9
South Pacific	1	5	3	0	0	9
Men Who Stare at Goats, The	1	3	5	0	0	9
Black Hole, The	0	3	2	2	2	9
Local Hero	3	4	2	0	0	9
Vampire in Brooklyn	0	3	4	1	1	9
Forces of Nature	0	1	3	3	2	9
Fame	1	3	3	2	0	9
Hard-Boiled (Lat sau san taam)	4	3	1	1	0	9
Ides of March, The	0	5	3	1	0	9
Madagascar 3: Europe's Most Wanted	2	3	3	1	0	9
Battle for the Planet of the Apes	1	2	1	4	1	9
Futurama: Bender's Game	0	5	3	1	0	9
Towering Inferno, The	1	4	2	1	1	9
Changing Lanes	1	3	5	0	0	9
Ted 2	1	2	2	3	1	9
Rising Sun	1	3	3	2	0	9
Bourne Identity, The	1	6	1	0	1	9
Jane Austen's Mafia!	0	0	2	4	3	9
Wimbledon	2	2	3	2	0	9
Land Before Time, The	0	5	3	1	0	9
Final Destination 3	0	3	4	1	1	9
Watch, The	0	4	3	1	1	9
John Tucker Must Die	0	4	2	1	2	9
Under the Tuscan Sun	1	3	4	1	0	9
Lady in the Water	0	3	5	0	1	9
She's Out of My League	1	5	1	0	2	9
Death Race	0	6	2	1	0	9
Road, The	1	7	1	0	0	9
Love and Death	5	2	2	0	0	9
Fly II, The	0	1	3	3	2	9
Campaign, The	1	4	4	0	0	9
Everything Is Illuminated	1	7	0	1	0	9
Green Zone	0	6	3	0	0	9
They Live	1	6	2	0	0	9
Bridge to Terabithia	0	4	3	1	1	9
Steel Magnolias	1	3	4	1	0	9
You Can Count on Me	5	1	3	0	0	9
The Fault in Our Stars	1	5	2	1	0	9
Jason Bourne	1	1	3	4	0	9
Cinderella Story, A	2	1	6	0	0	9
FLCL	5	3	1	0	0	9
Equalizer, The	1	4	3	1	0	9
Night at the Opera, A	4	5	0	0	0	9
Cocoon: The Return	0	0	5	2	2	9
Red Eye	0	5	4	0	0	9
Elephant	1	6	1	1	0	9
Naked Lunch	2	3	4	0	0	9
Psycho	0	1	1	5	2	9
Flight	1	5	2	1	0	9
Kung Pow: Enter the Fist	1	4	3	0	1	9
Winged Migration (Peuple migrateur, Le)	2	3	4	0	0	9
Core, The	0	2	3	1	2	8
Time Machine, The	2	2	4	0	0	8
Assault on Precinct 13	0	4	4	0	0	8
Analyze That	0	2	3	3	0	8
Tinker Tailor Soldier Spy	3	3	1	1	0	8
Next Stop Wonderland	1	2	4	1	0	8
I Love Trouble	0	0	7	0	1	8
NeverEnding Story II: The Next Chapter, The	0	2	3	2	1	8
Slums of Beverly Hills, The	1	3	4	0	0	8
Heart and Souls	1	2	3	1	1	8
Aguirre: The Wrath of God (Aguirre, der Zorn Gottes)	3	4	1	0	0	8
Man from Earth, The	3	4	1	0	0	8
Way of the Gun, The	1	2	4	1	0	8
Beowulf	0	1	4	3	0	8
Mary Reilly	0	3	1	3	1	8
Problem Child 2	0	0	1	2	5	8
Outrageous Fortune	0	1	5	2	0	8
Brewster's Millions	0	2	4	2	0	8
Fiddler on the Roof	3	4	0	0	1	8
Law Abiding Citizen	0	3	4	1	0	8
Atlantic City	1	4	3	0	0	8
Antonia's Line (Antonia)	4	2	1	0	1	8
Grand Canyon	0	4	2	2	0	8
Calendar Girls	1	2	2	0	3	8
Don Jon	1	3	3	1	0	8
Last Castle, The	0	2	4	1	1	8
White Noise	0	1	2	5	0	8
Show Me Love (Fucking Åmål)	2	3	3	0	0	8
Balto	0	2	5	1	0	8
Saving Mr. Banks	0	7	0	1	0	8
Great Mouse Detective, The	1	4	3	0	0	8
Jet Li's Fearless (Huo Yuan Jia)	0	3	4	1	0	8
It's Kind of a Funny Story	1	5	0	1	1	8
Black Cauldron, The	2	3	3	0	0	8
Last Temptation of Christ, The	1	5	2	0	0	8
Sweet November	1	3	3	0	1	8
Freaky Friday	0	1	3	4	0	8
Maria Full of Grace (Maria, Llena eres de gracia)	1	6	1	0	0	8
Black Knight	0	1	2	4	1	8
Warriors, The	2	4	2	0	0	8
Bed of Roses	2	4	2	0	0	8
Never Say Never Again	1	1	6	0	0	8
Orphanage, The (Orfanato, El)	2	6	0	0	0	8
Kingsman: The Golden Circle	0	4	3	0	1	8
Last Boy Scout, The	1	5	1	1	0	8
Metropolitan	1	5	0	2	0	8
Breathless (À bout de souffle)	2	5	0	1	0	8
Blended	2	5	0	1	0	8
Best Years of Our Lives, The	3	3	2	0	0	8
Flash Gordon	2	1	2	3	0	8
Octopussy	1	4	2	1	0	8
Last Picture Show, The	4	4	0	0	0	8
Plan 9 from Outer Space	1	2	3	2	0	8
Just Married	1	1	4	1	1	8
Insomnia	1	5	2	0	0	8
Volver	3	4	1	0	0	8
Mr. Nice Guy (Yat goh ho yan)	0	1	4	3	0	8
Paulie	0	1	2	4	1	8
Honeymoon in Vegas	0	3	2	3	0	8
Charlie Wilson's War	2	4	0	1	1	8
Karate Kid, The	0	4	0	2	2	8
Masters of the Universe	0	2	3	2	1	8
Big Kahuna, The	1	2	3	0	2	8
What Happens in Vegas...	0	4	1	2	1	8
Ali	0	2	6	0	0	8
Mystery, Alaska	1	5	2	0	0	8
South Park: Imaginationland	2	6	0	0	0	8
Firewall	0	1	6	1	0	8
Home Alone 3	0	1	2	1	4	8
Mannequin	0	2	3	2	1	8
Deconstructing Harry	2	4	1	1	0	8
Midnight Express	2	5	0	1	0	8
Cabin Fever	0	4	1	2	1	8
Home for the Holidays	1	0	6	1	0	8
Winter's Bone	2	2	4	0	0	8
Day of the Dead	2	5	0	1	0	8
Life Less Ordinary, A	2	0	4	2	0	8
Conan the Destroyer	0	3	4	1	0	8
Lord of Illusions	0	2	4	0	2	8
Dragon: The Bruce Lee Story	0	2	5	0	1	8
[REC]	3	4	1	0	0	8
Last Detail, The	2	6	0	0	0	8
Five Easy Pieces	5	3	0	0	0	8
Family Stone, The	1	2	3	1	1	8
Food, Inc.	2	3	3	0	0	8
Sea Inside, The (Mar adentro)	4	2	2	0	0	8
Boys from Brazil, The	1	4	3	0	0	8
Loaded Weapon 1 (National Lampoon's Loaded Weapon 1)	0	1	2	3	2	8
Videodrome	2	5	1	0	0	8
Vegas Vacation (National Lampoon's Las Vegas Vacation)	0	1	3	2	2	8
Bad Girls	0	1	3	3	1	8
Brave Little Toaster, The	2	2	4	0	0	8
Jacket, The	0	4	3	0	1	8
Fierce Creatures	0	2	5	1	0	8
Mother	0	3	2	3	0	8
Proposition, The	0	6	2	0	0	8
Cat People	0	3	2	2	1	8
Home	2	3	1	1	1	8
Jersey Girl	0	3	4	0	1	8
Friday Night Lights	1	5	2	0	0	8
Get Hard	1	3	2	2	0	8
Guys and Dolls	3	3	2	0	0	8
Night on Earth	4	3	0	1	0	8
White Christmas	3	5	0	0	0	8
Crank: High Voltage	0	4	2	1	1	8
Man on Wire	3	4	0	0	1	8
Stalker	2	3	2	1	0	8
Catch-22	1	4	3	0	0	8
Restoration	0	3	4	1	0	8
American Gigolo	0	2	3	2	1	8
Domino	0	2	5	1	0	8
Changeling	0	4	4	0	0	8
Kinsey	0	5	1	1	1	8
Bad Lieutenant	1	4	2	0	1	8
Return to Me	1	3	4	0	0	8
Manon of the Spring (Manon des sources)	1	7	0	0	0	8
Just Like Heaven	0	2	3	2	1	8
Mystic Pizza	1	4	1	2	0	8
Three Men and a Little Lady	1	0	3	4	0	8
Horton Hears a Who!	0	4	4	0	0	8
Jason X	0	0	1	1	6	8
Cat Returns, The (Neko no ongaeshi)	1	6	1	0	0	8
Eagle Eye	0	4	4	0	0	8
Antitrust	2	3	3	0	0	8
Herbie Rides Again	1	2	2	2	1	8
Dennis the Menace	0	1	1	4	2	8
D3: The Mighty Ducks	0	1	3	2	2	8
Life of David Gale, The	2	4	2	0	0	8
Adventures of Robin Hood, The	3	3	2	0	0	8
Bridge of Spies	0	6	1	0	1	8
Affair to Remember, An	3	3	1	1	0	8
Hail, Caesar!	0	3	2	3	0	8
Puss in Boots	2	4	1	1	0	8
Fanboys	1	2	3	1	1	8
Windtalkers	1	1	3	3	0	8
Creed	2	5	1	0	0	8
House of Games	2	4	2	0	0	8
Volunteers	1	1	2	4	0	8
Tigerland	1	4	3	0	0	8
Near Dark	4	3	1	0	0	8
She's the One	1	2	3	2	0	8
Seven Year Itch, The	0	5	2	1	0	8
Fan, The	1	1	4	2	0	8
Eight Legged Freaks	0	3	3	1	1	8
Kung Fu Panda 3	1	4	1	2	0	8
Barefoot in the Park	0	3	5	0	0	8
For Love of the Game	0	4	3	1	0	8
Dick	1	4	3	0	0	8
Celtic Pride	0	0	5	3	0	8
Chasing Liberty	4	1	3	0	0	8
Bloodsport 2 (a.k.a. Bloodsport II: The Next Kumite)	1	0	4	3	0	8
Blue Crush	0	1	6	0	1	8
Stakeout	0	2	4	2	0	8
Fever Pitch	0	4	3	0	1	8
Chronicle	3	2	1	1	1	8
This Is England	2	6	0	0	0	8
Swamp Thing	0	3	3	2	0	8
Tom and Huck	1	0	5	1	1	8
Year of Living Dangerously, The	2	3	3	0	0	8
Jane Eyre	2	0	5	0	1	8
Kingdom, The	2	5	1	0	0	8
Captain Ron	0	1	6	1	0	8
In the Mouth of Madness	2	2	3	1	0	8
Angel Heart	0	4	2	0	2	8
Lady Eve, The	3	4	0	0	1	8
Night of the Comet	1	2	1	3	1	8
Project X	1	1	1	3	2	8
Rio	1	3	2	2	0	8
Three Billboards Outside Ebbing, Missouri	8	0	0	0	0	8
Pagemaster, The	0	2	4	2	0	8
Only You	3	0	4	1	0	8
Bird on a Wire	0	0	3	5	0	8
Suspiria	4	2	1	1	0	8
Mod Squad, The	2	2	1	2	1	8
Ravenous	0	3	4	0	1	8
Dead Ringers	2	3	2	1	0	8
Miss Congeniality 2: Armed and Fabulous	0	1	3	3	1	8
Big Top Pee-Wee	0	1	2	2	3	8
Striking Distance	0	0	5	2	1	8
Gorillas in the Mist	1	5	2	0	0	8
Cheaper by the Dozen	0	0	3	3	2	8
Ghostbusters	0	4	3	1	0	8
Bad Education (La mala educación)	3	4	0	1	0	8
Breach	3	2	1	2	0	8
Paris, I Love You (Paris, je t'aime)	0	3	4	1	0	8
Soul Man	0	0	5	3	0	8
Be Cool	0	1	3	3	1	8
Total Recall	0	4	3	1	0	8
Armed and Dangerous	0	2	2	4	0	8
Running Scared	2	2	3	1	0	8
At First Sight	0	1	4	3	0	8
Playing by Heart	1	3	3	1	0	8
Earth Girls Are Easy	0	0	4	3	1	8
The Shape of Water	0	7	1	0	0	8
Alpha Dog	0	5	0	3	0	8
Killing Zoe	0	6	2	0	0	8
War Dogs	1	6	1	0	0	8
Heartbreak Kid, The	0	2	4	1	1	8
Pale Rider	2	3	3	0	0	8
Jack Frost	0	0	2	5	1	8
Hell or High Water	1	6	0	0	1	8
Paperman	4	3	1	0	0	8
G.I. Joe: The Rise of Cobra	0	1	5	2	0	8
Andromeda Strain, The	1	4	3	0	0	8
This Is 40	1	2	3	2	0	8
Sid and Nancy	0	5	2	1	0	8
Runaway Train	0	3	4	1	0	8
Fearless	0	5	3	0	0	8
Lars and the Real Girl	1	6	0	0	1	8
Batman: The Dark Knight Returns, Part 2	3	2	3	0	0	8
Toxic Avenger, The	0	1	2	3	2	8
Soldier	0	3	3	2	0	8
Perfume: The Story of a Murderer	0	4	4	0	0	8
Hacksaw Ridge	3	3	2	0	0	8
Win a Date with Tad Hamilton!	0	2	5	0	1	8
Indecent Proposal	1	1	4	2	0	8
Olympus Has Fallen	1	1	4	2	0	8
Osmosis Jones	0	2	3	3	0	8
Blame It on Rio	1	2	3	2	0	8
Clean Slate	0	2	3	3	0	8
Treasure Planet	2	3	3	0	0	8
Hangover Part III, The	1	4	3	0	0	8
Monsters vs. Aliens	0	4	3	1	0	8
Touching the Void	2	5	1	0	0	8
What a Girl Wants	0	3	4	1	0	8
Bullitt	1	6	1	0	0	8
Pokémon: The First Movie	0	2	2	2	2	8
Holiday Inn	2	3	1	2	0	8
Bamboozled	0	4	2	1	1	8
Room	3	2	2	1	0	8
Once Upon a Time in China (Wong Fei Hung)	1	2	4	0	0	7
Duplex	1	0	1	4	1	7
Speechless	0	1	5	0	1	7
Wonderland	0	5	1	1	0	7
Texas Chainsaw Massacre, The	0	1	2	1	3	7
Pieces of April	1	4	0	1	1	7
Shattered Glass	3	2	1	1	0	7
Cabinet of Dr. Caligari, The (Cabinet des Dr. Caligari., Das)	2	3	2	0	0	7
Highlander II: The Quickening	0	1	0	5	1	7
Night of the Hunter, The	2	4	1	0	0	7
Quick Change	0	5	2	0	0	7
Teen Wolf	1	1	5	0	0	7
In America	2	4	1	0	0	7
Prince & Me, The	0	2	4	1	0	7
Mask	0	5	1	1	0	7
Ella Enchanted	0	4	3	0	0	7
Cellular	0	1	5	0	1	7
Whole Ten Yards, The	1	2	2	2	0	7
Scenes From a Marriage (Scener ur ett äktenskap)	2	5	0	0	0	7
After Hours	0	7	0	0	0	7
Without a Paddle	0	0	4	1	2	7
Princess Diaries 2: Royal Engagement, The	0	2	2	3	0	7
Look Who's Talking Too	0	0	3	1	3	7
Zelig	1	6	0	0	0	7
Bridge Too Far, A	1	6	0	0	0	7
Last Starfighter, The	2	3	1	1	0	7
Mean Streets	2	4	1	0	0	7
*batteries not included	0	4	3	0	0	7
Escape from Alcatraz	1	5	1	0	0	7
Body Snatchers	0	1	6	0	0	7
Color of Night	0	2	1	4	0	7
Cowboy Way, The	0	1	3	3	0	7
With Honors	0	2	3	2	0	7
In the Army Now	0	1	0	5	1	7
North	0	1	2	2	2	7
Planet Earth	4	1	2	0	0	7
Romper Stomper	1	4	1	0	1	7
Sausage Party	3	3	0	0	1	7
Fear	2	1	2	1	1	7
Angus	0	3	3	1	0	7
Quest, The	0	1	4	1	1	7
Cemetery Man (Dellamorte Dellamore)	1	5	1	0	0	7
Sisters	0	2	1	3	1	7
Stealing Beauty	1	3	3	0	0	7
Spitfire Grill, The	0	4	2	0	1	7
Funny Face	1	3	0	2	1	7
Gaslight	3	3	1	0	0	7
Ghost and Mrs. Muir, The	1	5	1	0	0	7
Top Hat	3	2	2	0	0	7
Thin Man, The	2	3	2	0	0	7
Straight Outta Compton	3	4	0	0	0	7
Jude	0	2	4	1	0	7
Mediterraneo	2	3	2	0	0	7
Withnail & I	1	5	1	0	0	7
Dead Presidents	0	2	3	2	0	7
The Secret Life of Pets	1	3	2	1	0	7
Kung Fury	1	4	2	0	0	7
The Lobster	3	3	1	0	0	7
Tomorrowland	1	1	2	1	2	7
Somewhere in Time	1	1	3	2	0	7
Breaking the Waves	3	3	0	1	0	7
Metro	0	3	1	2	1	7
McHale's Navy	0	0	3	2	2	7
Kolya (Kolja)	4	3	0	0	0	7
Pirates of the Caribbean: Dead Men Tell No Tales	1	5	1	0	0	7
Brassed Off	2	3	1	1	0	7
U Turn	1	4	0	1	1	7
RocketMan (a.k.a. Rocket Man)	0	1	2	2	2	7
Mortal Kombat: Annihilation	0	0	3	2	2	7
Man Who Knew Too Little, The	0	1	1	4	1	7
Apostle, The	0	2	4	0	1	7
Mouse Hunt	1	0	6	0	0	7
Don't Be a Menace to South Central While Drinking Your Juice in the Hood	0	2	3	1	1	7
He Got Game	0	3	3	1	0	7
Krippendorf's Tribe	0	1	2	4	0	7
Major League: Back to the Minors	0	0	3	4	0	7
Big Hit, The	2	1	1	2	1	7
Tom Jones	0	5	2	0	0	7
Kicking and Screaming	1	3	1	1	1	7
Oliver!	1	3	2	1	0	7
Transcendence	0	1	3	2	1	7
The Raid 2: Berandal	2	3	2	0	0	7
Nightmare on Elm Street 4: The Dream Master, A	0	1	3	2	1	7
Nightmare on Elm Street 5: The Dream Child, A	0	2	1	1	3	7
Friday the 13th Part 2	0	2	1	3	1	7
Friday the 13th Part 3: 3D	0	1	2	2	2	7
Enemy	0	5	1	1	0	7
Lolita	2	4	1	0	0	7
Computer Wore Tennis Shoes, The	0	1	4	2	0	7
Inside Llewyn Davis	2	3	1	1	0	7
Day of the Doctor, The	5	2	0	0	0	7
47 Ronin	1	2	1	1	2	7
Angels and Insects	4	0	2	0	1	7
Cujo	0	0	2	5	0	7
Dunston Checks In	0	0	5	1	1	7
Who's Afraid of Virginia Woolf?	3	3	1	0	0	7
Conjuring, The	2	5	0	0	0	7
Lone Ranger, The	0	4	1	1	1	7
Henry: Portrait of a Serial Killer	2	4	1	0	0	7
Dead Man on Campus	0	1	1	5	0	7
Dirty Work	1	1	4	1	0	7
Lifeboat	4	2	1	0	0	7
Fast & Furious 6 (Fast and the Furious 6, The)	1	3	2	1	0	7
Shadow of a Doubt	2	4	1	0	0	7
My Bodyguard	2	2	3	0	0	7
Practical Magic	2	2	0	3	0	7
Vampires	1	0	2	3	1	7
Misérables, Les	0	5	2	0	0	7
Mona Lisa	1	4	0	2	0	7
Nights of Cabiria (Notti di Cabiria, Le)	2	5	0	0	0	7
Rugrats Movie, The	0	1	3	2	1	7
Batman: The Dark Knight Returns, Part 1	1	6	0	0	0	7
Police Academy 4: Citizens on Patrol	1	0	2	1	3	7
Little Voice	2	3	2	0	0	7
Here Comes the Boom	0	3	2	1	1	7
Taken 2	2	2	1	1	1	7
Waiting to Exhale	0	0	4	2	1	7
Peggy Sue Got Married	1	2	3	0	1	7
Beasts of the Southern Wild	1	2	4	0	0	7
20 Dates	0	4	1	0	2	7
Jawbreaker	0	1	1	3	2	7
Haunting, The	2	3	2	0	0	7
NeverEnding Story III, The	0	0	2	3	2	7
Lolita	0	4	3	0	0	7
Barry Lyndon	2	3	1	1	0	7
Twilight Saga: Breaking Dawn - Part 1, The	0	1	2	3	1	7
Radio Days	0	3	3	1	0	7
Thomas Crown Affair, The	2	4	1	0	0	7
Margin Call	2	2	3	0	0	7
Iron Eagle	0	0	3	3	1	7
Muse, The	0	3	3	0	1	7
Adventures of Milo and Otis, The (Koneko monogatari)	3	2	2	0	0	7
Stop Making Sense	3	1	3	0	0	7
Tommy	0	3	2	1	1	7
Armour of God II: Operation Condor (Operation Condor) (Fei ying gai wak)	1	3	1	1	1	7
Random Hearts	1	1	1	2	2	7
Superstar	2	1	3	1	0	7
Louis C.K.: Shameless	4	2	0	0	1	7
Sullivan's Travels	2	4	1	0	0	7
Louis C.K.: Chewed Up	3	1	1	0	2	7
Melancholia	2	3	0	0	2	7
Help!	0	4	3	0	0	7
Just Go with It	2	2	1	1	1	7
Elite Squad: The Enemy Within (Tropa de Elite 2 - O Inimigo Agora É Outro)	4	3	0	0	0	7
Piranha	1	0	3	2	1	7
Quest for Fire (Guerre du feu, La)	2	3	1	1	0	7
Tourist, The	0	2	3	1	1	7
Chronicles of Narnia: The Voyage of the Dawn Treader, The	3	2	2	0	0	7
Love and Other Drugs	0	2	3	2	0	7
Tora! Tora! Tora!	1	5	1	0	0	7
Verdict, The	4	2	1	0	0	7
Next Three Days, The	2	3	2	0	0	7
Unstoppable	0	5	2	0	0	7
Shampoo	2	1	1	2	1	7
Jagged Edge	1	3	3	0	0	7
Let Me In	2	4	1	0	0	7
Resident Evil: Afterlife	0	4	2	1	0	7
Grand Illusion (La grande illusion)	2	2	2	1	0	7
Dinner for Schmucks	1	3	2	1	0	7
Mr. Nobody	3	4	0	0	0	7
Shrek Forever After (a.k.a. Shrek: The Final Chapter)	3	2	1	1	0	7
Presidio, The	0	1	4	2	0	7
To Sir with Love	2	4	1	0	0	7
Flamingo Kid, The	1	1	2	2	1	7
Ghost Writer, The	2	3	2	0	0	7
Percy Jackson & the Olympians: The Lightning Thief	0	1	4	1	1	7
Born Yesterday	2	5	0	0	0	7
Searchers, The	2	4	1	0	0	7
Who's Harry Crumb?	0	3	0	4	0	7
Blind Date	0	0	4	2	1	7
Invictus	1	4	2	0	0	7
Jungle Fever	0	2	4	1	0	7
Bamba, La	0	1	5	1	0	7
Gamer	0	5	2	0	0	7
Secret in Their Eyes, The (El secreto de sus ojos)	3	3	0	0	1	7
Rules of Engagement	0	2	4	1	0	7
Mystery Train	3	1	1	2	0	7
Where the Heart Is	0	5	2	0	0	7
Year One	0	2	4	0	1	7
Land of the Lost	1	4	1	0	1	7
Gold Rush, The	3	3	1	0	0	7
Death and the Maiden	1	2	4	0	0	7
Fabulous Baker Boys, The	0	1	6	0	0	7
Paul Blart: Mall Cop	0	2	4	0	1	7
Underworld: Rise of the Lycans	2	3	2	0	0	7
Defiance	2	5	0	0	0	7
Reader, The	0	5	1	1	0	7
Doubt	1	3	3	0	0	7
Day the Earth Stood Still, The	0	0	7	0	0	7
Breaker Morant	1	5	1	0	0	7
Wave, The (Welle, Die)	0	5	2	0	0	7
Cat Ballou	0	2	4	1	0	7
Star Wars: The Clone Wars	0	1	3	2	1	7
Mummy: Tomb of the Dragon Emperor, The	0	1	5	1	0	7
Contender, The	0	3	2	2	0	7
Transformers: The Movie	1	4	1	0	1	7
Jerky Boys, The	1	0	1	2	3	7
Pledge, The	1	3	2	0	1	7
Run Fatboy Run	0	4	2	1	0	7
Other Boleyn Girl, The	1	5	1	0	0	7
Sugar & Spice	0	2	2	2	1	7
Flowers in the Attic	0	2	3	1	1	7
3000 Miles to Graceland	1	0	3	3	0	7
Hitman	1	3	2	1	0	7
Dish, The	1	6	0	0	0	7
Man of the House	0	3	2	1	1	7
Hot Rod	1	3	1	2	0	7
Fido	0	3	4	0	0	7
Surf's Up	0	5	2	0	0	7
Mr. Brooks	3	3	1	0	0	7
Princess and the Warrior, The (Krieger und die Kaiserin, Der)	2	2	3	0	0	7
Inglorious Bastards (Quel maledetto treno blindato)	3	2	1	0	1	7
Host, The (Gwoemul)	2	4	1	0	0	7
Bully	2	3	1	0	1	7
Good Shepherd, The	0	3	3	1	0	7
Wet Hot American Summer	2	3	1	1	0	7
Road House	0	2	3	2	0	7
War of the Roses, The	0	5	2	0	0	7
Flushed Away	1	4	2	0	0	7
Altered States	2	2	2	1	0	7
Together (Tillsammans)	1	4	2	0	0	7
Jackass Number Two	2	3	1	0	1	7
Jeepers Creepers	0	2	2	2	1	7
Jesus Camp	3	4	0	0	0	7
Band of Brothers	4	2	1	0	0	7
Invincible	0	4	2	0	1	7
National Lampoon's Senior Trip	1	0	1	5	0	7
Heist	0	4	3	0	0	7
United 93	3	4	0	0	0	7
Lord of the Flies	1	3	3	0	0	7
Party, The	0	4	3	0	0	7
Pink Panther, The	0	3	2	2	0	7
World's Fastest Indian, The	0	6	1	0	0	7
Grandma's Boy	0	1	4	1	1	7
Rollerball	0	0	1	4	2	7
Matador, The	0	4	1	2	0	7
Crossroads	1	0	1	4	1	7
Ferngully: The Last Rainforest	0	4	2	1	0	7
Chicken Little	0	2	1	3	1	7
Revolver	2	1	2	2	0	7
American Pie Presents: Band Camp (American Pie 4: Band Camp)	0	1	3	1	2	7
Shopgirl	0	3	3	1	0	7
Slap Shot	3	2	1	1	0	7
Proof	1	3	3	0	0	7
Joe Versus the Volcano	1	3	1	2	0	7
Murder by Numbers	0	1	5	1	0	7
Enigma	0	3	4	0	0	7
Dogtown and Z-Boyz	1	5	1	0	0	7
Four Brothers	1	4	2	0	0	7
Unfaithful	1	3	3	0	0	7
Devil's Rejects, The	2	3	2	0	0	7
Lords of Dogtown	1	2	2	2	0	7
Sisterhood of the Traveling Pants, The	1	2	2	2	0	7
Rabbit-Proof Fence	2	2	3	0	0	7
Kicking & Screaming	0	2	3	1	1	7
Master of Disguise, The	0	2	0	3	2	7
Spy Kids 2: The Island of Lost Dreams	0	1	3	1	2	7
24 Hour Party People	0	4	3	0	0	7
Simone (S1m0ne)	0	2	2	1	2	7
Johnny Dangerously	0	3	1	3	0	7
Barbershop	0	1	4	2	0	7
Sahara	0	2	5	0	0	7
Stealing Harvard	0	0	4	3	0	7
John Wick: Chapter Two	3	3	1	0	0	7
Pacifier, The	0	0	6	1	0	7
Gallipoli	5	1	1	0	0	7
I Spy	0	1	2	4	0	7
Coach Carter	0	2	5	0	0	7
The Lego Batman Movie	2	4	0	0	1	7
King of Comedy, The	2	5	0	0	0	7
Tears of the Sun	0	3	1	2	1	7
Dreamcatcher	0	2	3	1	1	7
House of 1000 Corpses	1	1	3	1	1	7
2046	2	5	0	0	0	7
Capturing the Friedmans	3	3	0	1	0	7
Hollywood Homicide	0	2	5	0	0	7
Wait Until Dark	0	6	0	0	1	7
THX 1138	2	4	1	0	0	7
Warcraft	0	5	0	1	0	6
Overboard	0	2	3	1	0	6
Dolce Vita, La	1	3	2	0	0	6
Eagle Has Landed, The	0	2	4	0	0	6
Night at the Museum: Secret of the Tomb	1	3	2	0	0	6
Transamerica	0	5	1	0	0	6
Beauty and the Beast (La belle et la bête)	0	4	1	1	0	6
Picture Perfect	0	2	1	3	0	6
Day of the Jackal, The	2	4	0	0	0	6
Freshman, The	0	1	5	0	0	6
In the Company of Men	3	2	0	1	0	6
Maze Runner: Scorch Trials	0	1	2	0	3	6
Jade	0	1	3	2	0	6
Taking of Pelham 1 2 3, The	0	2	4	0	0	6
Vantage Point	0	4	2	0	0	6
Snow Dogs	1	0	2	1	2	6
Dragonslayer	1	5	0	0	0	6
Shipping News, The	0	3	1	2	0	6
Nanny McPhee	0	2	4	0	0	6
Wings of the Dove, The	4	1	1	0	0	6
Inherent Vice	1	3	2	0	0	6
Following	0	6	0	0	0	6
Lookout, The	0	4	1	1	0	6
Eye for an Eye	1	3	2	0	0	6
TMNT (Teenage Mutant Ninja Turtles)	0	2	4	0	0	6
Tales from the Hood	0	1	4	1	0	6
Out-of-Towners, The	0	0	2	2	2	6
Failure to Launch	0	3	2	1	0	6
Punisher: War Zone	0	2	3	1	0	6
She's the Man	2	2	2	0	0	6
Everest	3	2	1	0	0	6
Bounty Hunter, The	0	0	5	1	0	6
Fireworks (Hana-bi)	2	3	1	0	0	6
Becoming Jane	0	1	4	1	0	6
Object of My Affection, The	0	0	4	2	0	6
Lantana	2	2	2	0	0	6
Man Bites Dog (C'est arrivé près de chez vous)	4	2	0	0	0	6
Made	0	1	3	2	0	6
Drag Me to Hell	2	3	1	0	0	6
Dark Shadows	0	1	2	3	0	6
Repo Men	2	2	1	1	0	6
Boy in the Striped Pajamas, The (Boy in the Striped Pyjamas, The)	1	3	1	0	1	6
Village of the Damned	0	3	1	2	0	6
Eye of the Beholder	0	0	1	2	3	6
Snow White and the Huntsman	0	2	3	1	0	6
Wing Commander	0	1	4	1	0	6
Rage: Carrie 2, The	0	0	0	5	1	6
Hills Have Eyes, The	1	2	2	1	0	6
Arizona Dream	2	4	0	0	0	6
Dead Pool, The	0	2	2	2	0	6
Hot Chick, The	0	1	4	1	0	6
Safety Not Guaranteed	0	5	1	0	0	6
Clockwatchers	1	4	1	0	0	6
This Film Is Not Yet Rated	0	4	2	0	0	6
Mutiny on the Bounty	1	5	0	0	0	6
Other Sister, The	1	2	2	1	0	6
Abraham Lincoln: Vampire Hunter	0	1	4	1	0	6
Daddy Day Care	0	1	3	1	1	6
200 Cigarettes	0	2	3	1	0	6
Man for All Seasons, A	3	2	1	0	0	6
Other Woman, The	1	1	1	3	0	6
Drumline	0	2	2	2	0	6
Prairie Home Companion, A	0	5	1	0	0	6
Transporter 3	0	2	1	3	0	6
True Grit	2	2	2	0	0	6
Klute	2	3	1	0	0	6
Message in a Bottle	0	2	2	2	0	6
White Chicks	0	2	3	1	0	6
Friday the 13th Part IV: The Final Chapter	0	1	2	3	0	6
Stick It	0	1	3	2	0	6
Eddie Murphy Raw	2	1	1	2	0	6
Ice Age 4: Continental Drift	0	2	3	0	1	6
Art School Confidential	1	2	2	1	0	6
Robin Hood	1	2	1	2	0	6
Poltergeist II: The Other Side	0	0	0	4	2	6
Vanishing, The (Spoorloos)	1	5	0	0	0	6
RoboCop	0	0	4	2	0	6
Tea with Mussolini	3	2	1	0	0	6
Fantastic Voyage	0	1	2	3	0	6
Waitress	1	5	0	0	0	6
Stepmom	2	1	0	3	0	6
Always	1	0	2	3	0	6
Invention of Lying, The	1	1	1	1	2	6
Mighty Joe Young	0	1	3	2	0	6
Monuments Men, The	0	2	3	0	1	6
You, Me and Dupree	0	0	4	1	1	6
Memphis Belle	0	2	3	1	0	6
Hide and Seek	0	0	4	1	1	6
My Super Ex-Girlfriend	0	1	1	1	3	6
Lean on Me	1	3	2	0	0	6
Ride Along	0	3	2	1	0	6
Nothing in Common	0	2	1	3	0	6
Master, The	2	2	2	0	0	6
Blank Check	0	1	2	2	1	6
End of Watch	1	4	1	0	0	6
Sinbad: Legend of the Seven Seas	0	6	0	0	0	6
D2: The Mighty Ducks	0	1	3	2	0	6
Charlie Brown Christmas, A	3	2	1	0	0	6
Return of Jafar, The	0	1	2	2	1	6
Return to Oz	0	2	3	1	0	6
Song of the South	0	3	3	0	0	6
Inland Empire	2	3	0	0	1	6
Cabin Boy	0	0	2	3	1	6
World Trade Center	0	1	3	2	0	6
Air America	1	0	3	2	0	6
Heat, The	1	3	2	0	0	6
Bandits	0	2	1	3	0	6
Gods Must Be Crazy II, The	2	1	3	0	0	6
Even Cowgirls Get the Blues	0	1	0	5	0	6
White House Down	0	3	1	1	1	6
Troop Beverly Hills	0	1	1	2	2	6
The Accountant	0	4	0	1	1	6
Beerfest	1	3	2	0	0	6
Education, An	1	4	1	0	0	6
Central Station (Central do Brasil)	3	3	0	0	0	6
Titus	2	3	1	0	0	6
Hearts in Atlantis	0	2	3	0	1	6
Blow-Up (Blowup)	1	3	2	0	0	6
SpaceCamp	0	0	2	3	1	6
Getaway, The	0	0	2	4	0	6
Bride of Chucky (Child's Play 4)	0	1	2	1	2	6
Holy Man	0	0	4	2	0	6
Next Friday	0	4	0	2	0	6
Side Effects	2	4	0	0	0	6
Trouble with Harry, The	1	2	2	1	0	6
Good Day to Die Hard, A	0	1	1	3	1	6
Big Trouble	0	0	4	1	1	6
Last Airbender, The	0	1	1	2	2	6
Black Dahlia, The	0	3	2	1	0	6
Wicker Man, The	0	6	0	0	0	6
Knight and Day	1	4	0	0	1	6
Babysitter, The	1	0	1	2	2	6
3 Ninjas	1	0	1	2	2	6
AVPR: Aliens vs. Predator - Requiem	0	2	1	2	1	6
Pecker	2	1	2	0	1	6
Unforgiven, The	2	2	2	0	0	6
Kids Are All Right, The	0	2	3	0	1	6
Invasion of the Body Snatchers	2	3	1	0	0	6
Inherit the Wind	2	3	1	0	0	6
Kubo and the Two Strings	2	3	1	0	0	6
Oz the Great and Powerful	1	2	1	2	0	6
The Magnificent Seven	1	4	1	0	0	6
Wristcutters: A Love Story	2	3	1	0	0	6
Lady Vanishes, The	1	4	1	0	0	6
Swept Away (Travolti da un insolito destino nell'azzurro mare d'Agosto)	4	2	0	0	0	6
Employee of the Month	0	1	4	1	0	6
One Crazy Summer	2	0	1	3	0	6
Roger Dodger	1	3	2	0	0	6
Crush, The	0	1	0	5	0	6
Pokémon the Movie 2000	0	0	2	1	3	6
I'll Do Anything	0	0	4	2	0	6
Ikiru	1	4	0	0	1	6
Heavyweights (Heavy Weights)	0	1	3	1	1	6
Sully	0	4	1	1	0	6
Naked	2	2	1	1	0	6
Switch, The	0	1	4	0	1	6
Confidence	0	3	0	2	1	6
The Legend of Tarzan	0	4	1	1	0	6
Monkeybone	0	1	2	1	2	6
Cursed	0	0	2	4	0	6
Life as We Know It	1	2	2	0	1	6
Cobb	0	3	2	1	0	6
Jeffrey	2	1	3	0	0	6
Audition (Ôdishon)	1	4	1	0	0	6
Terminal Velocity	0	1	3	2	0	6
War Room, The	0	3	2	1	0	6
Matewan	2	4	0	0	0	6
Commando	1	2	3	0	0	6
Jackass 3D	2	2	2	0	0	6
Doc Hollywood	0	2	4	0	0	6
Little Big League	0	1	3	1	1	6
Mansfield Park	0	2	3	1	0	6
Snowden	2	3	1	0	0	6
Ernest Scared Stupid	0	1	2	0	3	6
August Rush	1	2	3	0	0	6
Of Mice and Men	0	4	2	0	0	6
Hellraiser: Bloodline	1	0	1	3	1	6
Morning Glory	0	1	4	1	0	6
Pallbearer, The	0	1	2	3	0	6
Futurama: Into the Wild Green Yonder	0	4	2	0	0	6
Harley Davidson and the Marlboro Man	0	3	1	2	0	6
Poison Ivy	0	1	0	4	1	6
Peter Pan	0	4	1	0	1	6
Mermaids	0	3	2	1	0	6
Meatballs Part II	0	2	0	1	3	6
Manhunter	2	3	1	0	0	6
Reversal of Fortune	1	4	0	1	0	6
Strada, La	4	2	0	0	0	6
Last Supper, The	1	2	2	1	0	6
Ichi the Killer (Koroshiya 1)	1	2	2	1	0	6
Revenge of the Nerds II: Nerds in Paradise	0	1	1	3	1	6
Bringing Down the House	0	0	3	2	1	6
Little Fockers	0	1	1	1	3	6
Gulliver's Travels	0	0	2	3	1	6
Amityville Horror, The	0	0	4	1	1	6
Lot Like Love, A	0	3	2	0	1	6
Omega Man, The	1	3	2	0	0	6
Enron: The Smartest Guys in the Room	2	3	1	0	0	6
House of Wax	0	0	3	1	2	6
Nighthawks	0	3	2	1	0	6
Stranger Than Paradise	3	1	1	1	0	6
Daddy's Home	0	3	1	1	1	6
K-19: The Widowmaker	0	4	1	1	0	6
American Movie	1	4	1	0	0	6
Adventures of Pinocchio, The	1	1	3	1	0	6
Look Who's Talking Now	0	1	0	1	4	6
Unknown	0	4	1	1	0	6
Split	2	2	1	0	1	6
Fired Up	2	2	1	1	0	6
High School High	0	1	1	2	2	6
She's Gotta Have It	0	3	2	1	0	6
Bringing Out the Dead	0	4	1	1	0	6
Basquiat	0	3	1	1	1	6
Bulletproof	1	0	3	1	1	6
Dangerous Lives of Altar Boys, The	0	4	2	0	0	6
Ninotchka	2	3	1	0	0	6
Tomcats	0	1	2	1	2	6
Very Long Engagement, A (Un long dimanche de fiançailles)	1	3	2	0	0	6
Gigi	2	0	3	1	0	6
Bear, The (Ours, L')	0	4	1	1	0	6
Laura	2	4	0	0	0	6
All That Jazz	2	3	1	0	0	6
Giant	1	4	1	0	0	6
East of Eden	0	6	0	0	0	6
Club Dread	0	0	2	3	1	6
Bounce	0	1	2	2	1	6
Someone to Watch Over Me	0	2	3	1	0	6
Everest	0	2	3	1	0	6
Highlander: Endgame (Highlander IV)	0	0	3	2	1	6
Josie and the Pussycats	0	2	0	0	4	6
Senna	3	2	0	0	1	6
Family Guy Presents: It's a Trap	1	3	2	0	0	6
Glimmer Man, The	0	1	4	1	0	6
Win Win	2	3	1	0	0	6
Believer, The	2	4	0	0	0	6
Gilda	0	6	0	0	0	6
That Darn Cat!	0	1	2	2	1	6
Titanic	3	1	0	1	1	6
Missing in Action	0	0	2	3	1	6
Ladies Man, The	0	0	1	2	3	6
Arthur	0	3	1	2	0	6
Daybreakers	0	5	1	0	0	6
After the Sunset	1	3	2	0	0	6
Sky High	1	2	1	1	1	6
Mixed Nuts	0	0	1	4	1	6
Three Caballeros, The	1	3	1	1	0	6
The Hunger	1	3	1	1	0	6
American Ultra	0	3	1	1	1	6
Center Stage	2	1	1	1	1	6
Quills	0	4	0	1	1	6
Attack the Block	1	2	3	0	0	6
Twilight Samurai, The (Tasogare Seibei)	2	3	1	0	0	6
She-Devil	0	1	2	1	2	6
Bitter Moon	1	1	4	0	0	6
Backbeat	0	3	3	0	0	6
Uptown Girls	1	0	3	2	0	6
Husbands and Wives	1	5	0	0	0	6
Persona	2	3	0	1	0	6
Scarlet Letter, The	1	0	1	3	1	6
Force 10 from Navarone	0	1	4	1	0	6
Nine Queens (Nueve reinas)	2	2	1	1	0	6
Ju-on: The Grudge	0	0	4	2	0	6
Ginger Snaps	1	5	0	0	0	6
How to Lose Friends & Alienate People	1	2	1	1	1	6
Armour of God (Long xiong hu di)	0	3	2	0	1	6
Southpaw	0	3	1	1	1	6
Candidate, The	0	4	2	0	0	6
Air Up There, The	0	0	2	4	0	6
30 Minutes or Less	0	2	3	1	0	6
Great Race, The	0	3	2	1	0	6
Passengers	0	5	1	0	0	6
Colombiana	1	0	2	2	1	6
Drop Dead Fred	2	0	0	4	0	6
Ladder 49	1	4	1	0	0	6
Vacation	1	3	1	1	0	6
Steve Jobs	2	2	2	0	0	6
Beyond Rangoon	0	2	1	1	2	6
Real Steel	0	4	1	0	1	6
Enchanted April	1	4	1	0	0	6
Burnt by the Sun (Utomlyonnye solntsem)	4	0	1	0	1	6
Tie Me Up! Tie Me Down! (¡Átame!)	0	2	3	1	0	6
Madonna: Truth or Dare	1	2	2	1	0	6
Cat's Eye	0	0	3	3	0	6
Pixels	0	1	3	1	1	6
Lost in La Mancha	0	2	4	0	0	6
Quiet Man, The	1	2	2	1	0	6
Exorcism of Emily Rose, The	0	1	4	1	0	6
Bad Taste	1	1	3	0	1	6
Furious 7	1	2	1	0	2	6
Johnny English Reborn	0	3	1	2	0	6
Walking Tall	0	3	2	0	1	6
Insurgent	1	1	2	1	1	6
Blob, The	1	1	1	3	0	6
The Alamo	1	3	2	0	0	6
Dreamscape	0	1	2	3	0	6
Paradise Lost: The Child Murders at Robin Hood Hills	2	3	1	0	0	6
Ridicule	0	4	2	0	0	6
Futurama: The Beast with a Billion Backs	0	4	2	0	0	6
Allan Quatermain and the Lost City of Gold	0	0	2	2	2	6
Rum Diary, The	1	3	2	0	0	6
Murder on the Orient Express	0	3	2	1	0	6
Me and Earl and the Dying Girl	1	3	2	0	0	6
Magdalene Sisters, The	3	3	0	0	0	6
First Daughter	2	0	3	1	0	6
Interpreter, The	0	3	3	0	0	6
Coffee and Cigarettes	0	5	1	0	0	6
Dope	1	3	2	0	0	6
Ready to Rumble	0	1	2	2	1	6
Grey, The	0	3	1	1	1	6
Jaws 3-D	0	0	0	3	3	6
Just Friends	1	1	2	2	0	6
The DUFF	2	0	3	1	0	6
Instinct	1	2	1	2	0	6
Girlfight	0	5	0	1	0	6
SubUrbia	1	3	2	0	0	6
School Ties	0	1	5	0	0	6
Jumanji: Welcome to the Jungle	0	5	1	0	0	6
Jason and the Argonauts	0	4	2	0	0	6
Justice League	0	2	1	2	1	6
Journey to the Center of the Earth	0	1	3	0	1	5
It's the Great Pumpkin, Charlie Brown	1	2	2	0	0	5
Jennifer 8	0	1	3	1	0	5
Gossip	0	0	2	3	0	5
Auntie Mame	1	3	0	1	0	5
Cabaret	0	2	2	1	0	5
East is East	1	1	1	2	0	5
Postman Always Rings Twice, The	1	1	3	0	0	5
Prince of Tides, The	0	3	1	1	0	5
Happening, The	0	3	1	1	0	5
Time Traveler's Wife, The	1	4	0	0	0	5
Malèna	1	3	1	0	0	5
Bachelor Party	1	1	1	1	1	5
Frequently Asked Questions About Time Travel	1	2	2	0	0	5
Pandorum	0	4	0	1	0	5
North Dallas Forty	0	2	1	2	0	5
Murphy's Romance	0	1	1	2	1	5
Paranormal Activity	2	0	2	1	0	5
Whip It	0	3	1	0	1	5
Dersu Uzala	2	3	0	0	0	5
Religulous	1	3	1	0	0	5
Brothers	0	4	1	0	0	5
Mo' Better Blues	1	1	3	0	0	5
Before Night Falls	2	3	0	0	0	5
Crazy Heart	1	4	0	0	0	5
Baby... Secret of the Lost Legend	0	1	0	3	1	5
Youth in Revolt	1	1	2	0	1	5
Dracula 2000	0	0	1	3	1	5
Leap Year	0	1	2	1	1	5
Girl Who Kicked the Hornet's Nest, The (Luftslottet som sprängdes)	2	3	0	0	0	5
Safe	1	0	2	1	1	5
Birdy	1	1	3	0	0	5
Beyond the Mat	0	4	1	0	0	5
Cop Out	1	0	2	1	1	5
Kid, The	2	2	1	0	0	5
Snow Day	0	1	1	2	1	5
Wind River	1	2	1	1	0	5
Dorian Gray	0	1	4	0	0	5
Spiderwick Chronicles, The	0	4	0	1	0	5
Battle of Algiers, The (La battaglia di Algeri)	4	0	1	0	0	5
Kiss of Death	0	1	4	0	0	5
Agnes of God	0	4	1	0	0	5
Big Easy, The	0	3	2	0	0	5
Four Lions	2	2	1	0	0	5
Draughtsman's Contract, The	1	2	2	0	0	5
Blue Valentine	0	3	1	0	1	5
Ernest Goes to Camp	0	0	0	3	2	5
Exam	1	4	0	0	0	5
Mr. Death: The Rise and Fall of Fred A. Leuchter, Jr.	2	2	1	0	0	5
Battlestar Galactica: Razor	2	2	0	1	0	5
Walk Hard: The Dewey Cox Story	1	1	3	0	0	5
The Falcon and the Snowman	0	2	3	0	0	5
Ip Man 2	1	2	1	0	1	5
7th Voyage of Sinbad, The	3	2	0	0	0	5
Bonfire of the Vanities	0	1	1	2	1	5
Flawless	1	3	1	0	0	5
Paranormal Activity 2	1	2	2	0	0	5
Diving Bell and the Butterfly, The (Scaphandre et le papillon, Le)	1	4	0	0	0	5
Peter's Friends	1	1	3	0	0	5
Saw IV	1	1	3	0	0	5
Face in the Crowd, A	2	3	0	0	0	5
Longest Yard, The	0	3	1	1	0	5
Day & Night	3	1	1	0	0	5
Someone Like You	1	2	2	0	0	5
Love Affair	2	0	2	1	0	5
Tailor of Panama, The	0	1	4	0	0	5
I Am Number Four	0	2	3	0	0	5
Story of Us, The	0	0	3	1	1	5
Pokémon 3: The Movie	0	0	3	0	2	5
Super	0	2	2	1	0	5
Palm Beach Story, The	3	1	1	0	0	5
Driven	0	1	3	1	0	5
One Night at McCool's	1	1	3	0	0	5
Voices from the List	3	1	1	0	0	5
Krull	0	1	3	1	0	5
Conformist, The (Conformista, Il)	2	3	0	0	0	5
Hang 'Em High	0	3	2	0	0	5
Incendies	2	3	0	0	0	5
Startup.com	0	3	2	0	0	5
Rush Hour 3	2	0	0	2	1	5
Mr. Popper's Penguins	1	0	1	3	0	5
Charlie Bartlett	1	2	2	0	0	5
Drive Me Crazy	0	1	1	2	1	5
Mumford	0	1	4	0	0	5
Spanish Apartment, The (L'auberge espagnole)	3	1	1	0	0	5
Buddy Holly Story, The	0	4	1	0	0	5
Perfect Blue	3	1	1	0	0	5
Yi Yi	3	2	0	0	0	5
Wild at Heart	1	2	2	0	0	5
Yards, The	1	2	0	2	0	5
Gentlemen Prefer Blondes	1	3	1	0	0	5
Headhunters (Hodejegerne)	0	4	1	0	0	5
Jack and Jill	0	2	0	2	1	5
Brighton Beach Memoirs	0	3	2	0	0	5
Sitter, The	1	1	1	2	0	5
Jules and Jim (Jules et Jim)	3	2	0	0	0	5
We Bought a Zoo	0	3	2	0	0	5
Underworld: Awakening	1	4	0	0	0	5
Run Silent Run Deep	1	1	3	0	0	5
Crazy/Beautiful	1	1	2	1	0	5
Batman	0	1	4	0	0	5
Crimson Rivers, The (Rivières pourpres, Les)	0	3	2	0	0	5
Wolf Man, The	2	1	1	1	0	5
Ghost Rider: Spirit of Vengeance	0	0	0	4	1	5
Castle, The	0	3	2	0	0	5
Dr. Seuss' The Lorax	1	1	2	1	0	5
Man Who Shot Liberty Valance, The	3	2	0	0	0	5
Jiro Dreams of Sushi	3	1	1	0	0	5
Reign Over Me	2	2	1	0	0	5
Walk on the Moon, A	0	1	4	0	0	5
Neon Genesis Evangelion: The End of Evangelion (Shin seiki Evangelion Gekijô-ban: Air/Magokoro wo, kimi ni)	3	2	0	0	0	5
Accidental Tourist, The	0	3	2	0	0	5
Wild Hogs	0	0	3	2	0	5
Accused, The	0	5	0	0	0	5
Beaches	1	1	1	2	0	5
Wanderlust	1	1	1	2	0	5
Anne Frank Remembered	2	1	2	0	0	5
Great Outdoors, The	1	1	1	2	0	5
Magic Mike	0	2	1	2	0	5
My Favorite Martian	0	0	2	2	1	5
My Stepmother Is an Alien	1	1	1	2	0	5
Simply Irresistible	2	1	1	1	0	5
Short Circuit 2	0	2	1	2	0	5
For the Birds	0	5	0	0	0	5
Planet Earth II	3	1	1	0	0	5
Premium Rush	0	2	2	1	0	5
Mighty Joe Young	0	1	3	0	1	5
Erik the Viking	0	1	4	0	0	5
Queen Margot (Reine Margot, La)	0	1	4	0	0	5
Police Academy 5: Assignment: Miami Beach	1	0	1	2	1	5
Dreamgirls	0	2	3	0	0	5
Silverado	0	3	1	1	0	5
Lifeforce	0	1	2	1	1	5
Hitchcock	0	4	1	0	0	5
Celebrity	0	1	3	0	1	5
Mr. Wrong	1	1	0	0	3	5
Hansel & Gretel: Witch Hunters	1	1	2	0	1	5
Nashville	1	1	3	0	0	5
Trial, The (Procès, Le)	5	0	0	0	0	5
The Greatest Showman	1	1	2	0	1	5
Stardust Memories	2	2	0	0	1	5
Them!	1	3	1	0	0	5
Jack the Giant Slayer	0	1	2	0	2	5
Six-String Samurai	1	3	0	1	0	5
Presumed Innocent	2	2	1	0	0	5
Butcher's Wife, The	0	2	2	1	0	5
Place Beyond the Pines, The	0	3	2	0	0	5
Seventh Sign, The	0	1	2	2	0	5
Hero	0	0	4	0	1	5
Pain & Gain	1	1	2	1	0	5
Ghosts of Mars	1	0	3	0	1	5
Paper Moon	0	4	1	0	0	5
Suspicion	2	2	1	0	0	5
Last Tango in Paris (Ultimo tango a Parigi)	3	2	0	0	0	5
54	0	0	1	3	1	5
Duel	0	2	3	0	0	5
Wrongfully Accused	0	1	2	1	1	5
Hollywoodland	0	2	3	0	0	5
Gia	0	4	1	0	0	5
Don't Say a Word	0	1	2	1	1	5
Attack of the Killer Tomatoes!	0	0	3	1	1	5
Joy Ride	1	2	1	0	1	5
Best Offer, The (Migliore offerta, La)	3	1	1	0	0	5
Half Nelson	1	3	1	0	0	5
Iron Monkey (Siu nin Wong Fei-hung ji: Tit Ma Lau)	1	2	2	0	0	5
Red 2	0	3	1	1	0	5
Grown Ups 2	2	1	1	1	0	5
Riddick	0	3	2	0	0	5
Swing Kids	2	0	3	0	0	5
Riding in Cars with Boys	0	2	3	0	0	5
Newsies	1	1	0	3	0	5
Journey of Natty Gann, The	0	3	2	0	0	5
Fandango	1	1	3	0	0	5
Tender Mercies	0	4	0	0	1	5
Topo, El	2	2	0	1	0	5
Who Killed the Electric Car?	0	4	1	0	0	5
Babes in Toyland	0	3	1	0	1	5
Omen, The	0	0	3	2	0	5
Child's Play 3	0	0	2	1	2	5
Halloween II	0	0	2	3	0	5
Out Cold	0	2	2	1	0	5
Swimming Pool	1	2	2	0	0	5
Big Bully	0	0	3	0	2	5
Freddy's Dead: The Final Nightmare (Nightmare on Elm Street Part 6: Freddy's Dead, A)	0	0	1	4	0	5
Noah	1	1	1	1	1	5
Beastmaster, The	1	0	1	3	0	5
Little Women	1	4	0	0	0	5
Fair Game	0	0	0	4	1	5
Slither	0	2	2	1	0	5
Madeline	0	1	2	1	1	5
Sex Tape	0	1	3	1	0	5
French Twist (Gazon maudit)	1	1	2	1	0	5
Purge: Anarchy, The	1	1	2	1	0	5
Akeelah and the Bee	1	3	1	0	0	5
Giver, The	1	0	1	1	2	5
Moscow on the Hudson	0	1	4	0	0	5
Let's Be Cops	0	2	3	0	0	5
Isle of Dogs	1	3	0	1	0	5
Jimmy Neutron: Boy Genius	0	2	3	0	0	5
King of New York	1	3	1	0	0	5
Palmetto	0	1	3	0	1	5
Two if by Sea	0	0	2	2	1	5
Deep Rising	0	1	1	2	1	5
Shooting Fish	2	2	1	0	0	5
Running Scared	0	2	3	0	0	5
Passion of Joan of Arc, The (Passion de Jeanne d'Arc, La)	2	2	1	0	0	5
When a Stranger Calls	0	0	0	2	3	5
For Richer or Poorer	0	2	1	2	0	5
Mad City	0	0	1	4	0	5
Penguins of Madagascar	1	3	1	0	0	5
Alien: Covenant	0	2	1	2	0	5
Another 48 Hrs.	0	2	2	1	0	5
Still Alice	1	3	1	0	0	5
Mrs. Brown (a.k.a. Her Majesty, Mrs. Brown)	1	2	2	0	0	5
Ulee's Gold	1	3	1	0	0	5
Tristan & Isolde	1	2	2	0	0	5
Funny Games	1	3	0	0	1	5
My Own Private Idaho	2	2	1	0	0	5
District 13 (Banlieue 13)	1	4	0	0	0	5
Lady Vengeance (Sympathy for Lady Vengeance) (Chinjeolhan geumjassi)	2	2	1	0	0	5
Wild	0	3	1	0	1	5
Slackers	0	2	0	2	1	5
New World, The	0	3	1	0	1	5
Birthday Girl	0	1	2	2	0	5
Big Fat Liar	1	1	2	1	0	5
Vanya on 42nd Street	2	2	1	0	0	5
Into the Woods	0	2	2	0	1	5
Three Burials of Melquiades Estrada, The	2	3	0	0	0	5
Wild America	0	0	4	0	1	5
Cat in the Hat, The	0	0	3	1	1	5
Hart's War	0	2	2	1	0	5
Taken 3	2	0	0	1	2	5
Pillow Book, The	0	1	1	2	1	5
Inventing the Abbotts	0	2	2	1	0	5
Selena	0	2	1	2	0	5
Booty Call	1	1	0	1	2	5
Fantastic Four	0	0	2	2	1	5
Prefontaine	0	4	0	1	0	5
Marvin's Room	0	2	2	1	0	5
Tin Men	0	1	3	1	0	5
Radio	1	4	0	0	0	5
Joyeux Noël (Merry Christmas)	1	3	1	0	0	5
Whisper of the Heart (Mimi wo sumaseba)	2	2	1	0	0	5
Prime	0	1	2	2	0	5
Crucible, The	1	3	1	0	0	5
The Wedding Ringer	2	1	2	0	0	5
Legend of Zorro, The	0	2	2	1	0	5
Fog, The	0	1	1	1	2	5
Preacher's Wife, The	1	1	3	0	0	5
Victoria	1	4	0	0	0	5
War, The	0	2	3	0	0	5
Until the End of the World (Bis ans Ende der Welt)	0	2	1	1	1	5
Greatest Game Ever Played, The	0	3	2	0	0	5
Diva	0	4	1	0	0	5
Paris Is Burning	3	2	0	0	0	5
Passion Fish	1	2	1	1	0	5
Human Nature	0	4	1	0	0	5
Baby-Sitters Club, The	0	1	3	1	0	5
Howling, The	0	2	1	2	0	5
Fog, The	0	2	0	2	1	5
Regarding Henry	0	4	1	0	0	5
13 Hours	1	2	1	1	0	5
Looking for Richard	0	5	0	0	0	5
PCU	0	1	2	2	0	5
Grizzly Man	0	5	0	0	0	5
To Gillian on Her 37th Birthday	0	0	2	3	0	5
Freeway	2	0	2	0	1	5
Joy	1	1	3	0	0	5
Sleeping with the Enemy	0	2	1	1	1	5
Stealth	0	0	4	1	0	5
Shaggy Dog, The	0	1	3	1	0	5
Agent Cody Banks	0	0	1	3	1	5
Pollyanna	1	0	3	0	1	5
Chamber, The	0	4	0	1	0	5
Maximum Risk	1	1	1	1	1	5
The Boss Baby	2	2	0	1	0	5
Meet John Doe	0	5	0	0	0	5
Edukators, The (Die Fetten Jahre sind vorbei)	2	3	0	0	0	5
Halloween: The Curse of Michael Myers (Halloween 6: The Curse of Michael Myers)	2	0	3	0	0	5
Sorry, Wrong Number	1	4	0	0	0	5
First Kid	0	0	2	2	1	5
Lovely & Amazing	1	1	1	2	0	5
Pumpkin	0	2	2	1	0	5
Larger Than Life	0	1	2	2	0	5
Solo: A Star Wars Story	1	3	1	0	0	5
Great White Hype, The	0	0	4	0	1	5
xXx: State of the Union	0	0	2	3	0	5
Stuart Little 2	1	0	2	1	1	5
Feeling Minnesota	0	0	4	1	0	5
Millennium Actress (Sennen joyû)	1	3	1	0	0	5
Trip to the Moon, A (Voyage dans la lune, Le)	1	2	2	0	0	5
Eddie	0	1	3	1	0	5
Beethoven's 2nd	0	0	1	2	2	5
Down and Out in Beverly Hills	1	0	3	1	0	5
Babette's Feast (Babettes gæstebud)	3	2	0	0	0	5
Thesis (Tesis)	2	1	2	0	0	5
Pink Panther Strikes Again, The	0	3	2	0	0	5
Ed	1	1	1	0	2	5
Neighbors 2: Sorority Rising	1	0	2	1	1	5
Princess Caraboo	0	1	3	0	1	5
Wasabi	1	2	2	0	0	5
Threesome	1	1	2	1	0	5
Bloody Sunday	0	3	2	0	0	5
Melinda and Melinda	0	2	3	0	0	5
Knockaround Guys	0	0	4	1	0	5
Rules of Attraction, The	2	1	1	1	0	5
Captain Fantastic	5	0	0	0	0	5
Discreet Charm of the Bourgeoisie, The (Charme discret de la bourgeoisie, Le)	3	2	0	0	0	5
Don't Breathe	0	3	2	0	0	5
House of the Spirits, The	0	3	1	1	0	5
Casino Royale	0	1	1	3	0	5
Medallion, The	1	1	1	0	2	5
Santa Clause 2, The	0	0	4	0	1	5
Geronimo: An American Legend	0	0	4	1	0	5
For Love or Money	0	1	2	2	0	5
Friday After Next	0	1	1	2	1	5
Quiet American, The	1	3	1	0	0	5
Police Academy: Mission to Moscow	0	0	0	1	4	5
Garfield: The Movie	1	0	1	1	2	5
Memories of Murder (Salinui chueok)	4	1	0	0	0	5
Visitor Q (Bizita Q)	1	2	1	0	1	5
Purple Rain	0	2	2	1	0	5
Lupin III: The Castle Of Cagliostro (Rupan sansei: Kariosutoro no shiro)	1	3	0	1	0	5
Jin Roh: The Wolf Brigade (Jin-Rô)	1	2	2	0	0	5
Taxi	1	1	2	1	0	5
Tokyo Godfathers	1	3	1	0	0	5
Au revoir les enfants	2	3	0	0	0	5
Broadway Danny Rose	1	4	0	0	0	5
Tremors II: Aftershocks	0	2	1	1	1	5
Wages of Fear, The (Salaire de la peur, Le)	0	4	0	0	1	5
China Syndrome, The	0	5	0	0	0	5
Babylon 5: In the Beginning	0	3	0	1	1	5
Outfoxed: Rupert Murdoch's War on Journalism	1	2	1	0	1	5
Max	0	1	3	1	0	5
Dickie Roberts: Former Child Star	0	1	2	1	1	5
Funny Thing Happened on the Way to the Forum, A	1	1	2	1	0	5
Ring Two, The	0	1	1	3	0	5
National Security	0	1	1	3	0	5
Blink	0	1	4	0	0	5
Bill Cosby, Himself	2	2	1	0	0	5
CB4 - The Movie	0	3	0	1	1	5
Open Water	1	1	1	0	2	5
Forgotten, The	0	1	2	2	0	5
Manchester by the Sea	1	2	0	1	1	5
Dirty Dancing: Havana Nights	1	1	3	0	0	5
Judgment at Nuremberg	1	2	2	0	0	5
Love Me If You Dare (Jeux d'enfants)	3	0	2	0	0	5
Cry-Baby	1	3	1	0	0	5
Sympathy for Mr. Vengeance (Boksuneun naui geot)	1	2	2	0	0	5
Hearts of Darkness: A Filmmakers Apocalypse	0	5	0	0	0	5
Leprechaun	0	2	0	2	1	5
Straw Dogs	1	4	0	0	0	5
Deep Red (Profondo rosso)	0	2	2	0	1	5
Faster Pussycat! Kill! Kill!	2	1	1	1	0	5
Music Man, The	1	4	0	0	0	5
Australia	1	1	2	1	0	5
Pumpkinhead	0	1	1	2	1	5
Gomorrah (Gomorra)	2	1	1	1	0	5
Wallace and Gromit in 'A Matter of Loaf and Death'	2	1	2	0	0	5
Cecil B. DeMented	1	2	1	1	0	5
F/X2 (a.k.a. F/X 2 - The Deadly Art of Illusion)	0	0	2	3	0	5
Revolutionary Road	1	2	2	0	0	5
Godzilla 2000 (Gojira ni-sen mireniamu)	0	1	0	3	1	5
Shane	1	4	0	0	0	5
Inkheart	0	3	2	0	0	5
Assault on Precinct 13	1	2	2	0	0	5
Coming Home	0	3	1	1	0	5
Hamlet	1	3	1	0	0	5
Departures (Okuribito)	3	1	1	0	0	5
Funny People	0	5	0	0	0	5
Waltz with Bashir (Vals im Bashir)	0	2	3	0	0	5
Good, the Bad, the Weird, The (Joheunnom nabbeunnom isanghannom)	1	3	1	0	0	5
Porky's Revenge	0	0	2	1	2	5
Farinelli: il castrato	0	4	0	1	0	5
Magnum Force	2	1	1	1	0	5
Get Carter	0	1	2	1	1	5
In the Loop	2	3	0	0	0	5
Pirate Radio	2	2	0	0	1	5
Benji	2	1	1	1	0	5
Monsieur Verdoux	1	3	1	0	0	5
Antichrist	1	2	2	0	0	5
Anchors Aweigh	0	4	0	0	1	5
My Science Project	1	0	1	2	0	4
Mr. Bean's Holiday	0	1	2	1	0	4
Air Bud	0	0	3	0	1	4
Mommie Dearest	0	1	3	0	0	4
Woman in Red, The	0	0	2	2	0	4
Heidi	0	0	3	0	1	4
Rookie of the Year	0	0	3	0	1	4
Dr. T and the Women	0	0	1	3	0	4
Little Giants	0	1	1	2	0	4
Crazies, The	1	2	0	1	0	4
Darkness Falls	0	0	1	3	0	4
Ten Commandments, The	1	2	1	0	0	4
Funny Games U.S.	3	1	0	0	0	4
Trial and Error	0	0	2	1	1	4
It Follows	2	1	1	0	0	4
8 Heads in a Duffel Bag	0	3	0	0	1	4
Woman on Top	0	0	1	2	1	4
Circus, The	2	2	0	0	0	4
Love Guru, The	0	1	1	1	1	4
Closet, The (Placard, Le)	1	1	1	1	0	4
Thing from Another World, The	0	3	1	0	0	4
Girl Who Played with Fire, The (Flickan som lekte med elden)	2	2	0	0	0	4
Breakfast on Pluto	0	4	0	0	0	4
Safe House	0	3	1	0	0	4
Gridlock'd	0	2	2	0	0	4
Zathura	0	2	2	0	0	4
Penelope	1	2	0	1	0	4
Murder at 1600	0	1	2	0	1	4
Away from Her	1	1	2	0	0	4
Project Almanac	1	2	1	0	0	4
Wolf Creek	0	3	0	1	0	4
Wild Strawberries (Smultronstället)	2	0	2	0	0	4
Louis C.K.: Live at The Comedy Store	3	0	1	0	0	4
Brooklyn	2	1	0	1	0	4
Derailed	0	2	2	0	0	4
Millions	0	2	2	0	0	4
Alamo, The	0	2	2	0	0	4
Buena Vista Social Club	2	2	0	0	0	4
Last Unicorn, The	2	0	1	1	0	4
Citizen Ruth	2	1	1	0	0	4
Oh, God!	0	1	1	1	1	4
Scooby-Doo 2: Monsters Unleashed	0	0	2	2	0	4
Trekkies	1	2	0	0	1	4
Taking Lives	0	2	2	0	0	4
Marked for Death	0	0	1	2	1	4
Eddie Murphy Delirious	2	2	0	0	0	4
Manderlay	1	3	0	0	0	4
Jonestown: The Life and Death of Peoples Temple	1	2	1	0	0	4
Bug	0	3	0	0	1	4
Taxi 2	2	1	1	0	0	4
Temple Grandin	3	1	0	0	0	4
When in Rome	0	1	1	1	1	4
Black Mirror: White Christmas	3	1	0	0	0	4
Just One of the Guys	0	1	1	2	0	4
Stay	0	3	0	0	1	4
House of the Dead, The	0	0	0	1	3	4
Vera Drake	0	2	1	0	1	4
Tower Heist	1	1	2	0	0	4
Kissing Jessica Stein	1	2	0	0	1	4
Man Who Fell to Earth, The	2	2	0	0	0	4
North Country	0	3	1	0	0	4
Elizabethtown	0	3	1	0	0	4
Cashback	1	0	3	0	0	4
Taking of Pelham One Two Three, The	2	2	0	0	0	4
Mirror Has Two Faces, The	1	1	1	1	0	4
In Her Shoes	0	2	1	1	0	4
Smokey and the Bandit II	0	1	0	2	1	4
Hot Tub Time Machine 2	0	1	2	1	0	4
No Direction Home: Bob Dylan	3	1	0	0	0	4
Smokey and the Bandit III	0	0	0	3	1	4
Shame	1	2	1	0	0	4
Sorority Boys	0	0	3	1	0	4
Clockstoppers	0	0	1	3	0	4
Seed of Chucky (Child's Play 5)	0	0	1	2	1	4
April Fool's Day	0	0	0	2	2	4
Amityville II: The Possession	0	0	0	2	2	4
Prophet, A (Un Prophète)	1	3	0	0	0	4
Paris, Texas	0	2	2	0	0	4
Hostel: Part II	0	1	1	1	1	4
Midnight Special	0	0	2	2	0	4
Brokedown Palace	1	1	1	0	1	4
Leatherheads	0	0	3	0	1	4
A Quiet Place	1	1	0	1	1	4
Paul Blart: Mall Cop 2	0	2	1	1	0	4
Breathless	0	0	1	2	1	4
San Andreas	0	0	2	1	1	4
Gigantic (A Tale of Two Johns)	2	1	1	0	0	4
Carnage	2	1	1	0	0	4
Youth	0	2	2	0	0	4
Haunted Honeymoon	0	0	0	3	1	4
We Need to Talk About Kevin	0	4	0	0	0	4
In Cold Blood	0	3	1	0	0	4
Independence Day: Resurgence	0	0	3	1	0	4
The Good Dinosaur	1	1	1	0	1	4
It's Complicated	0	2	0	2	0	4
Damien: Omen II	0	2	1	0	1	4
Von Ryan's Express	0	4	0	0	0	4
Why We Fight	0	3	0	1	0	4
Man on the Train (Homme du train, L')	1	3	0	0	0	4
Thing, The	1	2	0	1	0	4
Death Wish	0	1	2	1	0	4
Universal Soldier: The Return	1	0	1	1	1	4
Book of Shadows: Blair Witch 2	0	0	1	0	3	4
Death at a Funeral	0	2	2	0	0	4
Confessions of a Teenage Drama Queen	0	0	2	2	0	4
The Diary of Anne Frank	1	3	0	0	0	4
Welcome to Mooseport	0	2	2	0	0	4
Skin I Live In, The (La piel que habito)	2	0	0	1	1	4
Amy	0	3	1	0	0	4
Microcosmos (Microcosmos: Le peuple de l'herbe)	1	3	0	0	0	4
Christmas Carol, A	0	3	0	1	0	4
Outside Providence	1	1	1	1	0	4
Willard	0	1	1	1	1	4
Saturn 3	1	0	2	1	0	4
Smurfs, The	0	0	1	2	1	4
Fist of Legend (Jing wu ying xiong)	2	0	1	0	1	4
Guard, The	0	3	1	0	0	4
Shall We Dance	2	2	0	0	0	4
Away We Go	0	2	2	0	0	4
Jakob the Liar	0	0	2	1	1	4
Zookeeper	1	0	2	0	1	4
The Gift	1	2	0	0	1	4
You Got Served	0	1	1	1	1	4
Beautiful Thing	2	2	0	0	0	4
Boat Trip	0	1	0	3	0	4
Psycho II	0	0	2	2	0	4
Dead Snow (Død snø)	1	3	0	0	0	4
Sanjuro (Tsubaki Sanjûrô)	3	1	0	0	0	4
Skeleton Key, The	0	1	3	0	0	4
Beginners	0	4	0	0	0	4
Angel Eyes	0	0	1	2	1	4
Call Me by Your Name	1	2	1	0	0	4
Doctor Who: The Waters of Mars	2	1	1	0	0	4
11:14	0	3	1	0	0	4
Summer Rental	0	1	1	1	1	4
View from the Top	0	0	3	1	0	4
	1	1	2	0	0	4
Perfect Score, The	0	1	2	1	0	4
Water for Elephants	0	3	1	0	0	4
Must Love Dogs	0	0	2	1	1	4
Big Bounce, The	0	0	2	1	1	4
Halloween	0	2	2	0	0	4
Luzhin Defence, The	0	2	2	0	0	4
Andalusian Dog, An (Chien andalou, Un)	2	2	0	0	0	4
Dying Young	1	2	0	1	0	4
Umbrellas of Cherbourg, The (Parapluies de Cherbourg, Les)	2	1	1	0	0	4
Man Without a Past, The (Mies vailla menneisyyttä)	0	4	0	0	0	4
13 Assassins (Jûsan-nin no shikaku)	2	1	1	0	0	4
It Takes Two	0	0	2	1	1	4
Hustle & Flow	0	4	0	0	0	4
Hobo with a Shotgun	0	0	2	2	0	4
Fury	2	1	0	0	1	4
Suicide Club (Jisatsu saakuru)	0	1	3	0	0	4
Demolition	0	2	1	1	0	4
Cool World	0	0	2	2	0	4
The Night Before	2	2	0	0	0	4
Once Bitten	0	1	1	2	0	4
Bad Seed, The	0	4	0	0	0	4
Fitzcarraldo	1	0	3	0	0	4
Silent Running	0	0	3	0	1	4
Bad Company	0	2	0	2	0	4
X-Files: I Want to Believe, The	0	1	3	0	0	4
My Man Godfrey	2	1	0	1	0	4
Divine Secrets of the Ya-Ya Sisterhood	0	2	1	1	0	4
Me and You and Everyone We Know	1	2	1	0	0	4
Hotel Transylvania 2	0	2	1	1	0	4
Battle: Los Angeles	0	1	1	1	1	4
Land of the Dead	1	1	1	0	1	4
Tekkonkinkreet (Tekkon kinkurîto)	3	1	0	0	0	4
Hall Pass	0	1	3	0	0	4
Better Luck Tomorrow	1	3	0	0	0	4
Mechanic, The	1	1	2	0	0	4
Losing Isaiah	1	1	1	1	0	4
Cheech & Chong's The Corsican Brothers	0	0	0	1	3	4
To Have and Have Not	1	2	1	0	0	4
The Big Sick	1	2	1	0	0	4
Men at Work	0	0	3	1	0	4
Orphan	0	2	1	1	0	4
Relic, The	1	1	0	1	1	4
T2: Trainspotting	0	4	0	0	0	4
Camp Nowhere	0	1	2	0	1	4
Sure Thing, The	0	4	0	0	0	4
Good Luck Chuck	1	0	3	0	0	4
House Arrest	0	2	2	0	0	4
Lust, Caution (Se, jie)	0	4	0	0	0	4
Three to Tango	0	1	2	1	0	4
Kong: Skull Island	0	2	1	1	0	4
Incredibles 2	0	2	1	0	1	4
Doctor Who: Planet of the Dead	1	1	1	0	1	4
Partly Cloudy	3	1	0	0	0	4
Adam's Rib	3	1	0	0	0	4
Monster-in-Law	0	0	3	1	0	4
Where Eagles Dare	2	1	1	0	0	4
Doctor Who: The Next Doctor	1	0	2	0	1	4
Doctor Who: The Runaway Bride	2	1	1	0	0	4
Music of the Heart	0	2	1	1	0	4
Say It Isn't So	0	0	2	1	1	4
Owning Mahowny	0	3	1	0	0	4
Diabolique (Les diaboliques)	1	2	0	0	1	4
How to Be Single	1	0	3	0	0	4
My Wife is an Actress (Ma Femme est une Actrice)	2	0	2	0	0	4
Sex and Lucia (Lucía y el sexo)	2	0	2	0	0	4
I Shot Andy Warhol	0	2	2	0	0	4
They Shoot Horses, Don't They?	0	2	1	1	0	4
Creepshow 2	0	1	2	1	0	4
Repossessed	0	1	1	1	1	4
On the Town	1	2	1	0	0	4
Porky's II: The Next Day	0	0	1	1	2	4
Cinemania	1	3	0	0	0	4
Dragnet	0	0	3	1	0	4
Secret World of Arrietty, The (Kari-gurashi no Arietti)	0	3	1	0	0	4
Visitors, The (Visiteurs, Les)	1	3	0	0	0	4
Dirty Grandpa	0	1	2	1	0	4
Tokyo Story (Tôkyô monogatari)	0	2	1	0	1	4
Legal Eagles	0	1	1	2	0	4
Eyes of Laura Mars	0	2	2	0	0	4
Necessary Roughness	0	0	3	1	0	4
Solo	0	1	0	1	2	4
Alphaville (Alphaville, une étrange aventure de Lemmy Caution)	2	1	1	0	0	4
The Brothers Grimsby	0	1	3	0	0	4
10	1	2	0	1	0	4
Boondock Saints II: All Saints Day, The	1	2	0	0	1	4
Rollerball	1	1	2	0	0	4
Sunshine Cleaning	0	3	0	1	0	4
Possession	1	1	2	0	0	4
Moll Flanders	1	0	2	0	1	4
Kung Fu Panda: Secrets of the Furious Five	0	2	1	0	1	4
Hunt for the Wilderpeople	3	1	0	0	0	4
Girl 6	0	1	2	1	0	4
Time After Time	0	4	0	0	0	4
Sing	0	3	1	0	0	4
Man Who Planted Trees, The (Homme qui plantait des arbres, L')	3	1	0	0	0	4
Theodore Rex	0	0	2	1	1	4
Girl on the Bridge, The (Fille sur le pont, La)	1	3	0	0	0	4
Freejack	0	0	0	4	0	4
Kiss of the Spider Woman	1	2	1	0	0	4
I Saw the Devil (Akmareul boatda)	1	2	1	0	0	4
Anatomy of a Murder	0	4	0	0	0	4
Seven Brides for Seven Brothers	2	0	2	0	0	4
Farscape: The Peacekeeper Wars	0	3	0	1	0	4
Ballad of Jack and Rose, The	0	1	3	0	0	4
Jeremiah Johnson	2	1	1	0	0	4
Alfie	0	2	2	0	0	4
Candyman: Farewell to the Flesh	0	1	2	1	0	4
Sex Drive	1	2	0	1	0	4
Irma la Douce	1	1	2	0	0	4
Knockin' on Heaven's Door	2	2	0	0	0	4
Celluloid Closet, The	1	2	1	0	0	4
Punchline	0	0	2	2	0	4
Andre	0	0	2	1	1	4
Spanking the Monkey	0	1	3	0	0	4
Gray's Anatomy	0	3	1	0	0	4
Beverly Hills Chihuahua	0	1	0	2	1	4
Get Over It	0	1	1	2	0	4
Widow of St. Pierre, The (Veuve de Saint-Pierre, La)	2	1	1	0	0	4
Kagemusha	2	2	0	0	0	4
Hud	0	4	0	0	0	4
Lizzie McGuire Movie, The	1	0	2	1	0	4
Carnival of Souls	1	2	1	0	0	4
Ice Princess	1	1	2	0	0	4
Valmont	1	2	1	0	0	4
Nothing to Lose	0	3	0	1	0	4
McCabe & Mrs. Miller	1	2	1	0	0	4
Joint Security Area (Gongdong gyeongbi guyeok JSA)	2	1	1	0	0	4
Synecdoche, New York	0	3	0	1	0	4
White Oleander	0	2	0	1	1	4
Alice Through the Looking Glass	0	0	2	1	1	4
New York, I Love You	1	2	1	0	0	4
Ruby in Paradise	0	2	2	0	0	4
Road to Wellville, The	0	0	2	2	0	4
Central Intelligence	1	2	1	0	0	4
Radioland Murders	0	2	2	0	0	4
Made of Honor	0	1	3	0	0	4
River, The	0	2	2	0	0	4
Puppet Masters, The	0	1	2	1	0	4
Places in the Heart	1	3	0	0	0	4
Ride with the Devil	1	2	1	0	0	4
Nerve	0	0	3	1	0	4
American, The	0	2	1	0	1	4
Blow Out	0	4	0	0	0	4
U2: Rattle and Hum	0	3	0	0	1	4
Lightning Jack	1	0	0	2	1	4
Judgment Night	0	0	1	3	0	4
Cove, The	1	3	0	0	0	4
Helvetica	0	2	2	0	0	4
Night Watch (Nochnoy dozor)	1	1	1	1	0	4
Valerian and the City of a Thousand Planets	1	0	1	2	0	4
Head Over Heels	0	0	3	1	0	4
Topsy-Turvy	1	2	1	0	0	4
Sleepaway Camp	0	1	1	1	1	4
Carnal Knowledge	0	2	2	0	0	4
Max Dugan Returns	0	0	2	2	0	4
But I'm a Cheerleader	0	2	0	1	1	4
Go Fish	0	1	2	0	1	4
Femme Fatale	0	2	2	0	0	4
Little Children	1	2	1	0	0	4
Less Than Zero	0	2	2	0	0	4
American Outlaws	0	1	1	0	2	4
Session 9	0	3	1	0	0	4
Captain Corelli's Mandolin	0	2	2	0	0	4
Admission	0	1	2	1	0	4
Wolf Children (Okami kodomo no ame to yuki)	1	2	1	0	0	4
Jaws: The Revenge	0	0	0	1	3	4
Host, The	1	1	0	0	2	4
Mr. Saturday Night	0	1	2	1	0	4
Class	1	1	1	1	0	4
Fresh	2	1	0	1	0	4
Happy Accidents	1	3	0	0	0	4
Guardian, The	0	1	3	0	0	4
We're No Angels	0	0	3	1	0	4
Nothing But Trouble	0	0	3	1	0	4
Toy Soldiers	0	1	1	2	0	4
House Party 2	0	0	0	0	4	4
The Emperor's Club	1	3	0	0	0	4
Chocolat	1	2	0	0	1	4
Mr. & Mrs. Smith	0	1	3	0	0	4
O	0	3	1	0	0	4
Basket Case	0	1	1	2	0	4
For Your Consideration	0	1	1	2	0	4
Haiku Tunnel	0	1	2	1	0	4
Weekend at Bernie's II	0	0	0	3	1	4
Saboteur	1	2	1	0	0	4
21 and Over	1	1	2	0	0	4
Easy Money	1	2	0	1	0	4
Identity Thief	1	1	0	2	0	4
Wrong Man, The	0	2	0	2	0	4
Duchess, The	1	1	1	1	0	4
Marnie	1	2	1	0	0	4
13 Ghosts	1	0	3	0	0	4
Way, Way Back, The	0	2	1	1	0	4
Jonah Hex	0	0	0	4	0	4
Eight Crazy Nights (Adam Sandler's Eight Crazy Nights)	0	0	1	1	2	4
Operation Petticoat	0	2	1	0	1	4
Wind That Shakes the Barley, The	0	4	0	0	0	4
Wicker Man, The	0	0	0	1	3	4
Play Misty for Me	0	3	1	0	0	4
Vanishing, The	0	0	2	2	0	4
Gods and Monsters	1	3	0	0	0	4
Supernova	0	1	0	1	2	4
Hitcher, The	0	3	1	0	0	4
Velvet Goldmine	0	2	2	0	0	4
Hudson Hawk	1	0	1	2	0	4
Twilight Saga: Breaking Dawn - Part 2, The	0	0	1	2	1	4
Purge, The	0	2	2	0	0	4
Return to Paradise	0	0	3	0	1	4
Way We Were, The	0	3	1	0	0	4
Buried	0	3	1	0	0	4
I Spit on Your Grave (Day of the Woman)	0	1	2	0	1	4
Summer School	0	0	2	2	0	4
Gifted	1	3	0	0	0	4
Painted Veil, The	2	1	1	0	0	4
Lincoln	3	1	0	0	0	4
Carnosaur	0	0	1	2	1	4
Observe and Report	1	0	1	1	1	4
Low Down Dirty Shame, A	0	1	1	1	1	4
Step Up	1	1	1	1	0	4
House II: The Second Story	0	1	0	0	3	4
Spriggan (Supurigan)	1	1	2	0	0	4
Sharknado	0	0	2	1	1	4
Zulu	2	0	2	0	0	4
Blue Jasmine	1	0	3	0	0	4
Louis C.K.: Oh My God	2	1	1	0	0	4
Smurfs 2, The	0	1	0	2	1	4
Wild Bill	0	1	2	1	0	4
Can't Buy Me Love	0	2	2	0	0	4
Freedom Writers	1	2	1	0	0	4
Autumn Sonata (Höstsonaten)	3	1	0	0	0	4
Needful Things	0	0	0	4	0	4
Scoop	1	1	2	0	0	4
To Do List, The	0	1	1	2	0	4
Nebraska	2	2	0	0	0	4
Baadasssss! (How to Get the Man's Foot Outta Your Ass)	0	3	1	0	0	4
Police Academy 6: City Under Siege	0	0	1	1	2	4
Raising Helen	0	1	2	1	0	4
Escape Plan	0	4	0	0	0	4
Notes on a Scandal	0	3	1	0	0	4
Brother	1	1	2	0	0	4
Return from Witch Mountain	0	0	2	1	1	4
All Is Lost	1	2	1	0	0	4
My Boss's Daughter	0	1	0	1	2	4
Delivery Man	0	0	4	0	0	4
Bell, Book and Candle	0	2	2	0	0	4
Pirates of Silicon Valley	1	3	0	0	0	4
Woman in the Dunes (Suna no onna)	3	1	0	0	0	4
Out of the Past	1	3	0	0	0	4
Incredible Journey, The	0	2	2	0	0	4
Herbie Goes Bananas	1	0	1	2	0	4
Darby O'Gill and the Little People	0	0	3	1	0	4
Killing Them Softly	1	1	1	1	0	4
Tape	1	2	1	0	0	4
Santa Claus: The Movie	0	0	1	3	0	4
Rugrats in Paris: The Movie	0	1	1	1	1	4
New York Stories	1	0	2	1	0	4
Down to You	0	0	2	0	2	4
Searching for Sugar Man	2	2	0	0	0	4
How to Get Ahead in Advertising	1	2	0	1	0	4
Odessa File, The	1	2	1	0	0	4
Apple Dumpling Gang Rides Again, The	0	0	4	0	0	4
Lawless	0	3	1	0	0	4
Dream Team, The	0	2	2	0	0	4
Ruby Sparks	1	2	0	1	0	4
Exorcist III, The	1	0	0	1	2	4
Exorcist II: The Heretic	0	0	0	3	1	4
That Awkward Moment	0	1	1	2	0	4
Confessions of a Shopaholic	1	1	2	0	0	4
Poltergeist III	0	0	2	0	2	4
Epic Movie	0	0	0	2	2	4
Novocaine	0	0	4	0	0	4
Non-Stop	0	3	0	1	0	4
Untamed Heart	0	3	0	1	0	4
300: Rise of an Empire	0	1	1	1	1	4
Child's Play 2	0	0	2	2	0	4
Mr. Peabody & Sherman	1	2	0	0	1	4
Poseidon	0	1	2	1	0	4
Priest	2	0	2	0	0	4
Hidden, The	0	2	2	0	0	4
Morvern Callar	1	0	3	0	0	4
Friday the 13th Part VI: Jason Lives	1	0	2	1	0	4
Man from Snowy River, The	1	1	1	1	0	4
Macbeth (a.k.a. Tragedy of Macbeth, The)	0	3	1	0	0	4
Return of the Living Dead, The	1	2	1	0	0	4
Midnight Meat Train, The	0	1	2	1	0	4
Why Him?	1	0	3	0	0	4
Kinky Boots	0	3	1	0	0	4
Original Kings of Comedy, The	0	2	1	1	0	4
Bright	0	2	1	0	1	4
Funny Girl	1	1	2	0	0	4
Bagdad Cafe (Out of Rosenheim)	1	2	1	0	0	4
The Lair of the White Worm	1	2	1	0	0	4
Unknown	0	2	1	1	0	4
Rock of Ages	0	1	1	2	0	4
I'm Gonna Git You Sucka	0	1	2	1	0	4
Weather Underground, The	0	4	0	0	0	4
That Obscure Object of Desire (Cet obscur objet du désir)	0	2	1	1	0	4
Toy, The	0	0	2	2	0	4
All the King's Men	2	2	0	0	0	4
Friends with Money	0	2	2	0	0	4
Airport '77	1	0	2	1	0	4
Gorky Park	0	4	0	0	0	4
Dear Zachary: A Letter to a Son About His Father	2	1	1	0	0	4
Jeepers Creepers 2	0	0	1	2	1	4
Black Snake Moan	0	2	2	0	0	4
Tale of Two Sisters, A (Janghwa, Hongryeon)	2	1	0	0	1	4
Transformers: Age of Extinction	0	0	1	3	0	4
Duck, You Sucker	1	2	1	0	0	4
Quicksilver	0	0	3	1	0	4
Merchant of Venice, The	1	2	1	0	0	4
Hercules	0	1	0	2	1	4
Bride Wars	0	4	0	0	0	4
Ernest Saves Christmas	0	1	0	0	3	4
Teenage Mutant Ninja Turtles	0	1	2	1	0	4
Dune	3	0	1	0	0	4
And Then There Were None	1	1	2	0	0	4
Throne of Blood (Kumonosu jô)	0	4	0	0	0	4
Character (Karakter)	0	1	1	2	0	4
Tinker, Tailor, Soldier, Spy	0	3	1	0	0	4
Sin City: A Dame to Kill For	0	1	3	0	0	4
Live Flesh (Carne trémula)	1	2	1	0	0	4
Chungking Express (Chung Hing sam lam)	3	0	1	0	0	4
Iris	1	2	1	0	0	4
True Crime	0	0	3	1	0	4
Odd Couple II, The	0	0	2	1	1	4
Dummy	0	3	1	0	0	4
Prelude to a Kiss	0	1	0	3	0	4
Tsotsi	0	2	2	0	0	4
Five-Year Engagement, The	0	2	1	0	1	4
Pierrot le fou	1	2	1	0	0	4
Best Exotic Marigold Hotel, The	2	1	1	0	0	4
Mirror Mirror	1	1	1	0	1	4
Four Musketeers, The	0	2	1	0	1	4
Animal Crackers	1	3	0	0	0	4
Abbott and Costello Meet Frankenstein	1	2	1	0	0	4
Dracula Untold	0	3	1	0	0	4
Christiane F. (a.k.a. We Children from Bahnhof Zoo) (Christiane F. - Wir Kinder vom Bahnhof Zoo)	0	4	0	0	0	4
Little Buddha	0	2	1	1	0	4
Play It Again, Sam	1	2	1	0	0	4
Hard Rain	0	0	2	2	0	4
Afterglow	2	2	0	0	0	4
Fury, The	0	2	1	0	1	4
Dreamlife of Angels, The (Vie rêvée des anges, La)	1	1	2	0	0	4
Eight Below	0	2	1	1	0	4
Party Girl	2	1	1	0	0	4
Sweet Smell of Success	1	3	0	0	0	4
Mr. Magoo	0	0	1	1	2	4
Samouraï, Le (Godson, The)	1	2	1	0	0	4
Kundun	0	2	1	1	0	4
Horse Whisperer, The	1	2	1	0	0	4
Slacker	0	3	0	1	0	4
Timecrimes (Cronocrímenes, Los)	2	2	0	0	0	4
American Reunion (American Pie 4)	0	2	0	2	0	4
Mrs. Dalloway	1	1	1	1	0	4
Life	0	2	1	1	0	4
Citizenfour	1	2	1	0	0	4
Wrath of the Titans	0	1	1	2	0	4
Monster, The (Mostro, Il)	0	2	2	0	0	4
Goods: Live Hard, Sell Hard, The	1	2	1	0	0	4
100 Girls	0	3	1	0	0	4
Enemy Mine	2	2	0	0	0	4
Riding Giants	2	1	1	0	0	4
Gone in 60 Seconds	0	2	1	1	0	4
Sophie Scholl: The Final Days (Sophie Scholl - Die letzten Tage)	4	0	0	0	0	4
All That Heaven Allows	2	2	0	0	0	4
House of Yes, The	0	3	0	1	0	4
DiG!	1	3	0	0	0	4
Secret of My Succe$s, The (a.k.a. The Secret of My Success)	0	2	2	0	0	4
Paddington	1	3	0	0	0	4
Goon	1	1	1	1	0	4
Born into Brothels	1	2	1	0	0	4
Hoodwinked!	0	3	0	1	0	4
Shape of Things, The	0	2	2	0	0	4
Tomb Raider	0	1	2	0	1	4
Traitor	0	2	2	0	0	4
Laws of Attraction	1	0	2	0	1	4
Creature from the Black Lagoon, The	0	0	2	1	1	4
Guy Thing, A	0	0	2	2	0	4
Excess Baggage	0	1	1	2	0	4
Envy	0	0	4	0	0	4
Leave It to Beaver	0	0	0	3	1	4
Hideaway	0	0	2	2	0	4
Desperate Measures	0	0	2	2	0	4
One False Move	0	3	1	0	0	4
Flight of the Phoenix	0	0	4	0	0	4
Runaway	0	1	1	2	0	4
War for the Planet of the Apes	1	1	0	1	1	4
Big Year, The	1	2	1	0	0	4
Lost and Delirious	1	1	2	0	0	4
Inferno	0	3	0	0	1	4
Ringer, The	0	1	2	1	0	4
Baraka	2	1	1	0	0	4
Cheaper by the Dozen 2	0	0	1	2	1	4
Monsieur Ibrahim (Monsieur Ibrahim et les fleurs du Coran)	0	3	0	0	0	3
Ant-Man and the Wasp	0	2	1	0	0	3
Annihilation	0	3	0	0	0	3
Wonder	1	1	1	0	0	3
Darkest Hour	1	1	1	0	0	3
I, Tonya	0	1	2	0	0	3
Murder on the Orient Express	0	1	2	0	0	3
Lady Bird	1	0	2	0	0	3
The Hitman's Bodyguard	0	1	1	1	0	3
Death Note	0	0	1	1	1	3
The Fate of the Furious	0	0	2	0	1	3
Baywatch	0	1	1	1	0	3
Office Christmas Party	1	1	1	0	0	3
While You Were Fighting: A Thor Mockumentary	0	3	0	0	0	3
Your Name.	1	2	0	0	0	3
Miss Peregrine's Home for Peculiar Children	0	2	0	1	0	3
Masterminds	1	2	0	0	0	3
Bad Moms	1	2	0	0	0	3
Mike & Dave Need Wedding Dates	1	1	0	1	0	3
Toni Erdmann	0	3	0	0	0	3
The Handmaiden	0	2	0	0	1	3
The Boss	0	1	1	1	0	3
Hush	1	0	1	0	1	3
The Huntsman Winter's War	0	0	0	1	2	3
Sing Street	0	3	0	0	0	3
Everybody Wants Some	1	2	0	0	0	3
Mr. Right	1	1	0	1	0	3
Eye in the Sky	0	2	0	1	0	3
Whiskey Tango Foxtrot	0	1	2	0	0	3
Eddie the Eagle	0	1	1	1	0	3
Ride Along 2	0	1	0	1	1	3
Zoolander 2	0	0	2	1	0	3
Doctor Who: Voyage Of The Damned	2	1	0	0	0	3
Doctor Who: The Doctor, the Widow and the Wardrobe	2	0	1	0	0	3
Concussion	0	1	1	1	0	3
Er ist wieder da	1	0	1	0	1	3
Burnt	0	0	1	2	0	3
Green Room	0	1	2	0	0	3
Turbo Kid	0	2	1	0	0	3
Black Mass	0	0	2	1	0	3
The Last Witch Hunter	1	1	0	1	0	3
Love & Mercy	1	2	0	0	0	3
Last Knights	0	2	0	1	0	3
The Amazing Screw-On Head	2	0	1	0	0	3
Pan	0	0	2	1	0	3
Run All Night	0	0	1	2	0	3
Operation 'Y' & Other Shurik's Adventures	1	1	1	0	0	3
Fifty Shades of Grey	0	0	0	1	2	3
The Salt of the Earth	2	1	0	0	0	3
Unbroken	0	0	2	1	0	3
In the Heart of the Sea	1	1	1	0	0	3
Doctor Who: The Time of the Doctor	2	1	0	0	0	3
Dumb and Dumber To	0	0	2	1	0	3
Simpsons: The Longest Daycare, The	1	1	1	0	0	3
Time Lapse	0	3	0	0	0	3
What We Do in the Shadows	3	0	0	0	0	3
Stretch	0	0	2	0	1	3
Two Night Stand	0	2	0	1	0	3
The Skeleton Twins	0	1	2	0	0	3
The Drop	0	1	1	1	0	3
The Expendables 3	0	2	1	0	0	3
I Origins	2	0	0	1	0	3
Babadook, The	3	0	0	0	0	3
Frank	2	1	0	0	0	3
Tangled Ever After	0	3	0	0	0	3
Begin Again	0	3	0	0	0	3
Locke	1	1	1	0	0	3
Muppets Most Wanted	0	2	1	0	0	3
Nut Job, The	1	2	0	0	0	3
Bad Words	0	0	2	0	1	3
Zero Theorem, The	0	2	0	1	0	3
Art of the Steal, The	0	2	1	0	0	3
Evangelion: 3.0 You Can (Not) Redo	0	0	2	1	0	3
Family, The	1	0	2	0	0	3
Austenland	0	1	2	0	0	3
What If	0	2	0	0	1	3
Jobs	0	1	0	2	0	3
Wind Rises, The (Kaze tachinu)	1	2	0	0	0	3
Great Beauty, The (Grande Bellezza, La)	1	1	0	1	0	3
2 Guns	1	2	0	0	0	3
Drinking Buddies	0	1	1	0	1	3
R.I.P.D.	0	0	1	1	1	3
Mud	1	2	0	0	0	3
Incredible Burt Wonderstone, The	0	0	3	0	0	3
G.I. Joe: Retaliation	0	1	2	0	0	3
Before Midnight	1	1	0	1	0	3
Movie 43	1	1	0	1	0	3
Upstream Color	0	1	2	0	0	3
Gangster Squad	0	2	1	0	0	3
Impossible, The (Imposible, Lo)	1	1	1	0	0	3
Guilt Trip, The	0	1	1	1	0	3
Robot & Frank	0	1	2	0	0	3
That's My Boy	0	1	0	2	0	3
Samsara	1	1	1	0	0	3
Piranha 3DD (a.k.a. Piranha DD)	0	1	0	2	0	3
Sidewalls (Medianeras)	0	2	1	0	0	3
Geri's Game	1	2	0	0	0	3
One Man Band	1	1	1	0	0	3
Seeking a Friend for the End of the World	1	2	0	0	0	3
Thousand Words, A	0	0	3	0	0	3
Get the Gringo	0	3	0	0	0	3
Pirates! Band of Misfits, The	0	2	1	0	0	3
Decoy Bride, The	1	1	1	0	0	3
Battleship	0	1	0	1	1	3
Lockout	1	0	1	1	0	3
Vow, The	0	1	1	1	0	3
Grave Encounters	0	2	0	1	0	3
Haywire	0	0	3	0	0	3
Man on a Ledge	0	2	0	1	0	3
Friends with Kids	1	1	1	0	0	3
New Year's Eve	0	0	1	2	0	3
War Horse	0	2	0	1	0	3
Immortals	1	0	1	0	1	3
Batman: Year One	1	1	1	0	0	3
Three Musketeers, The	0	1	2	0	0	3
Killer Elite	0	1	1	1	0	3
Separation, A (Jodaeiye Nader az Simin)	1	2	0	0	0	3
Inbetweeners Movie, The	0	3	0	0	0	3
Cars 2	0	1	2	0	0	3
Everything Must Go	0	1	1	1	0	3
Submarine	1	2	0	0	0	3
The Man from Nowhere	2	1	0	0	0	3
Priest	0	1	2	0	0	3
Scream 4	0	0	2	1	0	3
American: The Bill Hicks Story	1	1	1	0	0	3
Insidious	0	1	1	1	0	3
BURN-E	2	1	0	0	0	3
Mesrine: Public Enemy #1 (L'ennemi public n°1)	1	1	0	1	0	3
Summer Wars (Samâ wôzu)	1	1	1	0	0	3
Evangelion: 2.0 You Can (Not) Advance (Evangerion shin gekijôban: Ha)	0	2	1	0	0	3
Yogi Bear	0	0	0	1	2	3
How Do You Know	0	1	1	1	0	3
Restrepo	0	1	2	0	0	3
Illusionist, The (L'illusionniste)	0	1	1	1	0	3
Never Let Me Go	0	3	0	0	0	3
Catfish	1	1	1	0	0	3
Wall Street: Money Never Sleeps	0	2	0	1	0	3
Flipped	1	2	0	0	0	3
Going the Distance	0	1	2	0	0	3
Jackass 2.5	2	0	1	0	0	3
Piranha (Piranha 3D)	0	0	2	0	1	3
Batman: Under the Red Hood	1	1	1	0	0	3
Letters to Juliet	0	2	0	0	1	3
Splice	0	2	1	0	0	3
Losers, The	0	1	2	0	0	3
Leaves of Grass	0	1	2	0	0	3
Greenberg	0	0	2	1	0	3
Room, The	2	0	0	0	1	3
[REC]²	1	1	1	0	0	3
Tooth Fairy	0	0	1	2	0	3
Persuasion	1	1	0	1	0	3
Valentine's Day	0	0	2	1	0	3
Legion	0	1	1	1	0	3
Rudolph, the Red-Nosed Reindeer	1	1	1	0	0	3
American Pie Presents: The Book of Love (American Pie 7: The Book of Love)	0	0	1	2	0	3
Alvin and the Chipmunks: The Squeakquel	1	0	0	1	1	3
Lovely Bones, The	0	1	2	0	0	3
Single Man, A	0	3	0	0	0	3
Planet 51	0	2	0	1	0	3
Ninja Assassin	1	2	0	0	0	3
Precious	0	2	1	0	0	3
Saw VI	1	0	2	0	0	3
Couples Retreat	1	0	2	0	0	3
Thirst (Bakjwi)	2	0	1	0	0	3
Final Destination, The (Final Destination 4) (Final Destination in 3-D, The)	0	0	2	1	0	3
Informant!, The	1	1	1	0	0	3
Halloween II	1	1	0	0	1	3
Taking Woodstock	0	2	0	1	0	3
Troll 2	2	0	0	0	1	3
Bronson	0	3	0	0	0	3
Miss March	1	1	0	0	1	3
Evangelion: 1.0 You Are (Not) Alone (Evangerion shin gekijôban: Jo)	0	3	0	0	0	3
Lost in Austen	0	2	1	0	0	3
12 Rounds	0	0	3	0	0	3
Roots	0	2	1	0	0	3
Ghosts of Girlfriends Past	0	1	1	1	0	3
Raiders of the Lost Ark: The Adaptation	2	1	0	0	0	3
Brothers Bloom, The	1	2	0	0	0	3
Red Cliff Part II (Chi Bi Xia: Jue Zhan Tian Xia)	1	2	0	0	0	3
State of Play	0	3	0	0	0	3
Outlander	0	1	2	0	0	3
Choke	0	2	1	0	0	3
5 Centimeters per Second (Byôsoku 5 senchimêtoru)	1	1	1	0	0	3
Dinotopia	0	2	1	0	0	3
Four Christmases	0	1	2	0	0	3
Saw V	1	0	1	1	0	3
My Best Friend's Girl	2	0	1	0	0	3
Max Payne	0	0	1	2	0	3
City of Ember	0	1	2	0	0	3
Babylon A.D.	0	1	1	0	1	3
Disaster Movie	0	0	0	0	3	3
Sukiyaki Western Django	1	0	2	0	0	3
Red Cliff (Chi bi)	1	2	0	0	0	3
Batman: Gotham Knight	0	2	1	0	0	3
Encounters at the End of the World	2	1	0	0	0	3
Wackness, The	1	1	1	0	0	3
Strangers, The	1	0	1	1	0	3
Son of Rambow	3	0	0	0	0	3
Forbidden Kingdom, The	1	1	1	0	0	3
Speed Racer	0	1	2	0	0	3
Superhero Movie	0	1	0	1	1	3
Heima	1	2	0	0	0	3
Diary of the Dead	0	1	1	1	0	3
Counterfeiters, The (Die Fälscher)	1	1	0	1	0	3
Fool's Gold	0	1	1	0	1	3
Meet the Spartans	0	2	0	0	1	3
Band's Visit, The (Bikur Ha-Tizmoret)	0	2	1	0	0	3
Kite Runner, The	0	2	1	0	0	3
Alvin and the Chipmunks	0	0	0	2	1	3
Black Sheep	0	0	2	0	1	3
Control	1	2	0	0	0	3
Game Plan, The	0	1	1	1	0	3
Mr. Woodcock	1	0	1	0	1	3
Hunting Party, The	0	0	3	0	0	3
In the Valley of Elah	0	2	1	0	0	3
4 Months, 3 Weeks and 2 Days (4 luni, 3 saptamâni si 2 zile)	0	3	0	0	0	3
Nanny Diaries, The	0	1	2	0	0	3
Balls of Fury	0	1	1	1	0	3
Tell No One (Ne le dis à personne)	0	3	0	0	0	3
License to Wed	0	0	2	0	1	3
Rescue Dawn	0	2	1	0	0	3
Nancy Drew	0	0	3	0	0	3
21 Up	0	3	0	0	0	3
Invisible, The	0	1	1	0	1	3
Reaping, The	0	0	2	1	0	3
Premonition	0	3	0	0	0	3
Namesake, The	0	2	1	0	0	3
The Odyssey	0	2	0	1	0	3
Hannibal Rising	1	0	2	0	0	3
Because I Said So	0	1	2	0	0	3
Seven Up!	0	3	0	0	0	3
American Pie Presents The Naked Mile (American Pie 5: The Naked Mile)	0	0	0	1	2	3
Curse of the Golden Flower (Man cheng jin dai huang jin jia)	0	0	2	1	0	3
Charlotte's Web	0	2	1	0	0	3
Fast Food Nation	1	1	1	0	0	3
10 Items or Less	0	1	1	1	0	3
Bobby	1	2	0	0	0	3
Let's Go to Prison	0	0	1	0	2	3
Shut Up & Sing	0	2	0	1	0	3
Good Year, A	0	2	1	0	0	3
Shortbus	1	2	0	0	0	3
Man of the Year	0	0	2	1	0	3
All the King's Men	0	1	2	0	0	3
Last Kiss, The	1	1	1	0	0	3
Angel-A	0	2	1	0	0	3
Adam's Apples (Adams æbler)	1	2	0	0	0	3
Tideland	0	2	0	1	0	3
Night Listener, The	0	0	3	0	0	3
Wordplay	0	3	0	0	0	3
Edmond	1	1	0	1	0	3
High School Musical	0	1	0	1	1	3
RV	0	0	1	2	0	3
Basic Instinct 2	0	0	2	0	1	3
Stay Alive	0	0	0	2	1	3
Date Movie	0	0	0	0	3	3
Block Party (a.k.a. Dave Chappelle's Block Party)	0	1	2	0	0	3
Tristram Shandy: A Cock and Bull Story	0	1	2	0	0	3
Last Holiday	0	2	1	0	0	3
Casanova	0	1	2	0	0	3
Rumor Has It...	0	0	3	0	0	3
Yours, Mine and Ours	1	0	2	0	0	3
Ice Harvest, The	1	1	1	0	0	3
Bittersweet Life, A (Dalkomhan insaeng)	1	2	0	0	0	3
Oliver Twist	0	3	0	0	0	3
Thumbsucker	0	2	1	0	0	3
Cave, The	0	1	1	1	0	3
The Great Raid	0	1	2	0	0	3
Deuce Bigalow: European Gigolo	1	0	0	2	0	3
Junebug	0	2	1	0	0	3
The Chumscrubber	0	0	0	3	0	3
Bad News Bears	0	0	3	0	0	3
Murderball	0	3	0	0	0	3
Dark Water	0	0	1	1	1	3
3 Extremes (Three... Extremes) (Saam gaang yi)	0	2	1	0	0	3
Herbie: Fully Loaded	1	0	1	1	0	3
It's All Gone Pete Tong	0	2	0	1	0	3
Rock School	0	3	0	0	0	3
Mad Hot Ballroom	0	2	1	0	0	3
Dear Wendy	0	2	1	0	0	3
Memories (Memorîzu)	1	1	1	0	0	3
D.E.B.S.	0	1	1	1	0	3
Guess Who	0	0	2	1	0	3
Cube Zero	0	1	1	1	0	3
Gunner Palace	0	2	1	0	0	3
Tyler Perry's Diary of a Mad Black Woman	0	1	0	2	0	3
Three Musketeers, The	0	3	0	0	0	3
Because of Winn-Dixie	0	1	2	0	0	3
Appleseed (Appurushîdo)	1	1	1	0	0	3
Sergeant York	1	1	1	0	0	3
Upside of Anger, The	0	1	2	0	0	3
Love Song for Bobby Long, A	0	2	1	0	0	3
Woodsman, The	1	2	0	0	0	3
3-Iron (Bin-jip)	2	1	0	0	0	3
Metallica: Some Kind of Monster	0	2	1	0	0	3
Return, The (Vozvrashcheniye)	2	1	0	0	0	3
Ghost in the Shell 2: Innocence (a.k.a. Innocence) (Inosensu)	0	0	2	0	1	3
Last Life in the Universe (Ruang rak noi nid mahasan)	1	2	0	0	0	3
Happiness of the Katakuris, The (Katakuri-ke no kôfuku)	2	1	0	0	0	3
Ali G Indahouse	0	2	0	1	0	3
Darkness	0	0	1	1	1	3
Ripley's Game	0	2	1	0	0	3
Asterix & Obelix: Mission Cleopatra (Astérix & Obélix: Mission Cléopâtre)	1	2	0	0	0	3
Batman Beyond: Return of the Joker	1	1	0	1	0	3
Gummo	0	1	2	0	0	3
Major League II	0	1	1	1	0	3
Bad Boy Bubby	3	0	0	0	0	3
Ladybugs	0	1	1	1	0	3
35 Up	0	3	0	0	0	3
Ghost Dad	0	0	1	0	2	3
Killer Klowns from Outer Space	0	0	1	2	0	3
Better Tomorrow, A (Ying hung boon sik)	1	1	1	0	0	3
Sacrifice, The (Offret - Sacraficatio)	1	2	0	0	0	3
Anne of Green Gables	2	1	0	0	0	3
Twilight Zone: The Movie	0	1	1	1	0	3
Hair	0	1	2	0	0	3
Silver Streak	0	2	1	0	0	3
Twelve Tasks of Asterix, The (Les douze travaux d'Astérix)	0	2	1	0	0	3
Play Time (a.k.a. Playtime)	1	1	0	0	1	3
Harakiri (Seppuku)	2	1	0	0	0	3
Easter Parade	0	2	1	0	0	3
Holiday	1	1	0	0	1	3
Stage Door	1	2	0	0	0	3
Control Room	1	2	0	0	0	3
I Am David	0	0	3	0	0	3
Birth	0	1	0	2	0	3
Alfie	0	0	1	2	0	3
Final Cut, The	1	1	1	0	0	3
Fearless Vampire Killers, The	0	2	1	0	0	3
Shall We Dance?	0	1	2	0	0	3
Cannibal Holocaust	0	1	1	1	0	3
Mr. 3000	0	1	1	1	0	3
Alice Doesn't Live Here Anymore	1	2	0	0	0	3
Wicker Park	0	2	1	0	0	3
Paparazzi	0	0	2	0	1	3
Vanity Fair	0	3	0	0	0	3
Exorcist: The Beginning	0	1	0	2	0	3
Little Black Book	0	0	1	2	0	3
Bachelor and the Bobby-Soxer, The	0	1	2	0	0	3
Day at the Races, A	1	2	0	0	0	3
Around the World in 80 Days	0	0	2	1	0	3
White Heat	0	2	1	0	0	3
Mindhunters	0	1	1	1	0	3
Oliver Twist	1	2	0	0	0	3
3 Women (Three Women)	1	2	0	0	0	3
Educating Rita	0	2	1	0	0	3
Crossroads	1	0	1	1	0	3
I Am a Fugitive from a Chain Gang	1	1	1	0	0	3
How to Steal a Million	0	2	1	0	0	3
Kikujiro (Kikujirô no natsu)	0	2	1	0	0	3
Brigadoon	1	2	0	0	0	3
Death Race 2000	1	1	0	1	0	3
Dark Days	0	2	1	0	0	3
Tremors 3: Back to Perfection	0	1	2	0	0	3
Gunga Din	0	1	2	0	0	3
After the Thin Man	0	2	0	0	1	3
Babylon 5: Thirdspace	0	3	0	0	0	3
Babylon 5: A Call to Arms	0	1	2	0	0	3
Postman Always Rings Twice, The	0	2	1	0	0	3
Witchfinder General (Conquerer Worm, The)	0	1	0	1	1	3
Miracle Worker, The	0	3	0	0	0	3
Pride and Prejudice	1	1	1	0	0	3
28 Up	0	3	0	0	0	3
Mad Dog and Glory	0	2	1	0	0	3
Spartan	0	3	0	0	0	3
Goodbye, Mr. Chips	0	3	0	0	0	3
Raw Deal	0	2	1	0	0	3
Diary of a Country Priest (Journal d'un curé de campagne)	0	3	0	0	0	3
Kitchen Stories (Salmer fra kjøkkenet)	0	3	0	0	0	3
Barbershop 2: Back in Business	0	1	0	1	1	3
Boy and His Dog, A	1	2	0	0	0	3
Pumping Iron	0	2	1	0	0	3
High Sierra	2	1	0	0	0	3
M. Hulot’s Holiday (Mr. Hulot's Holiday) (Vacances de Monsieur Hulot, Les)	0	2	1	0	0	3
Mon Oncle (My Uncle)	0	3	0	0	0	3
Honey	0	1	2	0	0	3
Grass	0	2	1	0	0	3
1941	0	1	1	1	0	3
42nd Street	1	2	0	0	0	3
Jezebel	1	1	1	0	0	3
Stagecoach	0	2	1	0	0	3
Jesus Christ Superstar	1	2	0	0	0	3
Witches, The	0	1	2	0	0	3
Salo, or The 120 Days of Sodom (Salò o le 120 giornate di Sodoma)	0	2	1	0	0	3
Passenger 57	1	1	0	1	0	3
Over the Top	0	0	1	0	2	3
Only the Lonely	0	1	2	0	0	3
Lover, The (Amant, L')	0	2	1	0	0	3
Lorenzo's Oil	0	2	1	0	0	3
Darkman	0	3	0	0	0	3
Timeline	0	0	2	0	1	3
Barbarian Invasions, The (Les invasions barbares)	1	2	0	0	0	3
Missing, The	0	3	0	0	0	3
Cercle Rouge, Le (Red Circle, The)	1	0	2	0	0	3
Sweet Sixteen	0	2	1	0	0	3
In the Cut	0	1	1	1	0	3
Bus 174 (Ônibus 174)	1	1	1	0	0	3
Leap of Faith	0	0	1	2	0	3
It's Pat	0	0	0	1	2	3
Cobra	0	1	0	2	0	3
Avalon	1	1	1	0	0	3
Rules of the Game, The (La règle du jeu)	0	2	1	0	0	3
Lagaan: Once Upon a Time in India	1	2	0	0	0	3
Anything Else	0	1	1	1	0	3
Kind Hearts and Coronets	1	1	0	0	1	3
Valley Girl	0	0	1	2	0	3
House of Wax	0	2	1	0	0	3
I Love You to Death	0	1	1	1	0	3
What's Up, Tiger Lily?	0	1	2	0	0	3
Remo Williams: The Adventure Begins	0	1	0	2	0	3
Buffalo Soldiers	0	2	1	0	0	3
Spy Kids 3-D: Game Over	0	1	0	1	1	3
Curly Sue	0	1	0	2	0	3
How to Deal	1	1	0	1	0	3
From Justin to Kelly	0	0	0	1	2	3
Mississippi Masala	1	1	0	1	0	3
This Boy's Life	1	0	2	0	0	3
Man with the Movie Camera, The (Chelovek s kino-apparatom)	1	0	1	1	0	3
Once a Thief (Zong heng si hai)	1	1	1	0	0	3
In-Laws, The	0	0	2	1	0	3
Breakin'	0	0	1	1	1	3
Breakin' 2: Electric Boogaloo	0	0	1	1	1	3
Chorus Line, A	2	1	0	0	0	3
Dancer Upstairs, The	1	1	1	0	0	3
Blue Car	0	2	1	0	0	3
Decade Under the Influence, A	0	3	0	0	0	3
My Father the Hero (Mon père, ce héros.)	0	0	2	0	1	3
Wildcats	0	0	1	1	1	3
I Am Trying to Break Your Heart	1	2	0	0	0	3
Flickering Lights (Blinkende lygter)	2	1	0	0	0	3
Malibu's Most Wanted	0	0	2	1	0	3
Lilya 4-Ever (Lilja 4-ever)	0	2	1	0	0	3
Akira Kurosawa's Dreams (Dreams)	2	1	0	0	0	3
Europa Europa (Hitlerjunge Salomon)	2	1	0	0	0	3
Hunted, The	0	0	3	0	0	3
Laurel Canyon	0	0	3	0	0	3
Spider	0	2	1	0	0	3
Cradle 2 the Grave	0	2	1	0	0	3
Poolhall Junkies	1	2	0	0	0	3
Dark Blue	0	1	2	0	0	3
Pillow Talk	1	1	1	0	0	3
Black Stallion, The	0	2	1	0	0	3
Gerry	0	2	1	0	0	3
White Dog	0	1	1	1	0	3
Midsummer Night's Sex Comedy, A	0	3	0	0	0	3
May	0	2	1	0	0	3
Harder They Come, The	2	0	1	0	0	3
Amen.	0	3	0	0	0	3
Dogfight	1	2	0	0	0	3
American Me	0	1	1	0	1	3
Blue Collar Comedy Tour: The Movie	0	2	0	1	0	3
Love Liza	0	2	1	0	0	3
Duellists, The	1	2	0	0	0	3
Return to the Blue Lagoon	0	0	0	2	1	3
Dog Soldiers	2	1	0	0	0	3
Standing in the Shadows of Motown	0	2	1	0	0	3
All or Nothing	1	1	1	0	0	3
Urban Cowboy	0	0	1	2	0	3
Auto Focus	0	1	2	0	0	3
Formula 51	0	0	3	0	0	3
Pride of the Yankees, The	0	2	1	0	0	3
Powaqqatsi	1	0	2	0	0	3
Moonlight Mile	0	2	1	0	0	3
8 Women	0	3	0	0	0	3
Banger Sisters, The	0	0	0	3	0	3
Indian Summer	0	1	1	1	0	3
City by the Sea	0	1	1	1	0	3
FearDotCom (a.k.a. Fear.com) (a.k.a. Fear Dot Com)	0	0	0	2	1	3
Adventures of Pluto Nash, The	0	0	2	1	0	3
Blood Work	0	1	2	0	0	3
Our Man Flint	0	2	1	0	0	3
Tadpole	1	0	1	1	0	3
Kid Stays in the Picture, The	1	2	0	0	0	3
Halloween: Resurrection (Halloween 8)	0	0	1	1	1	3
Z	0	3	0	0	0	3
Perfect	0	0	0	3	0	3
The Importance of Being Earnest	2	1	0	0	0	3
Powerpuff Girls, The	0	2	1	0	0	3
Manhattan Project, The	0	0	3	0	0	3
Silver Bullet (Stephen King's Silver Bullet)	0	0	2	1	0	3
Caveman	0	1	0	2	0	3
Gangster No. 1	0	1	1	1	0	3
Fast Runner, The (Atanarjuat)	1	1	1	0	0	3
84 Charing Cross Road	2	1	0	0	0	3
Thirteen Conversations About One Thing (a.k.a. 13 Conversations)	1	1	1	0	0	3
Enough	2	0	1	0	0	3
Every Which Way But Loose	0	1	1	1	0	3
Delirious	0	0	3	0	0	3
Bob le Flambeur	0	1	2	0	0	3
Stir Crazy	1	1	1	0	0	3
Hopscotch	0	3	0	0	0	3
Scratch	1	1	1	0	0	3
Dragonfly	0	2	1	0	0	3
Sleuth	1	2	0	0	0	3
Adventures of Huck Finn, The	0	0	2	1	0	3
Waydowntown	1	1	0	1	0	3
Storytelling	0	2	0	1	0	3
Son's Room, The (Stanza del figlio, La)	1	1	1	0	0	3
Impostor	0	1	2	0	0	3
Truly, Madly, Deeply	1	1	0	1	0	3
Murder by Death	0	0	3	0	0	3
Joe Somebody	0	1	2	0	0	3
Stunt Man, The	2	1	0	0	0	3
Now, Voyager	1	1	1	0	0	3
Midway	0	1	2	0	0	3
Not Without My Daughter	0	0	1	1	1	3
Bones	0	0	1	0	2	3
My First Mister	0	1	2	0	0	3
Corky Romano	0	0	1	0	2	3
Coal Miner's Daughter	0	2	1	0	0	3
Changeling, The	0	2	1	0	0	3
Max Keeble's Big Move	0	0	2	1	0	3
Silkwood	1	2	0	0	0	3
Father Goose	0	2	1	0	0	3
Opera	1	1	0	0	1	3
Phantom of the Paradise	2	0	1	0	0	3
Hardball	0	1	1	1	0	3
L.I.E.	1	2	0	0	0	3
Rock Star	0	0	2	1	0	3
Summer Catch	0	1	1	1	0	3
Curse of the Jade Scorpion, The	0	1	1	0	1	3
Deep End, The	0	0	1	1	1	3
Paint Your Wagon	0	0	3	0	0	3
Black Robe	0	2	1	0	0	3
Tango & Cash	0	0	0	2	1	3
She's Out of Control	0	2	0	0	1	3
See No Evil, Hear No Evil	0	1	2	0	0	3
Bread and Tulips (Pane e tulipani)	1	1	1	0	0	3
Punisher, The	0	0	1	2	0	3
Millennium	0	0	0	3	0	3
Meet the Feebles	0	0	3	0	0	3
Harlem Nights	0	0	3	0	0	3
Casualties of War	1	1	1	0	0	3
Black Rain	0	1	1	1	0	3
Young Einstein	0	0	0	3	0	3
Tetsuo, the Ironman (Tetsuo)	0	3	0	0	0	3
Running on Empty	2	1	0	0	0	3
Red Heat	0	0	2	1	0	3
License to Drive	0	0	2	1	0	3
Frantic	0	1	2	0	0	3
Critters	0	0	3	0	0	3
Colors	0	1	2	0	0	3
Caddyshack II	0	0	0	2	1	3
Bright Lights, Big City	1	0	1	1	0	3
Blob, The	0	1	1	1	0	3
Big Business	0	1	0	1	1	3
Arthur 2: On the Rocks	0	0	1	0	2	3
Way of the Dragon, The (a.k.a. Return of the Dragon) (Meng long guo jiang)	1	2	0	0	0	3
Last Dragon, The	1	0	1	0	1	3
Game of Death	1	2	0	0	0	3
Fist of Fury (Chinese Connection, The) (Jing wu men)	1	1	1	0	0	3
Garden of the Finzi-Continis, The (Giardino dei Finzi-Contini, Il)	0	2	1	0	0	3
Shadows and Fog	0	2	1	0	0	3
Alice	0	1	2	0	0	3
Pootie Tang	1	0	1	1	0	3
Divided We Fall (Musíme si pomáhat)	0	3	0	0	0	3
Anniversary Party, The	1	1	1	0	0	3
Rio Bravo	0	2	1	0	0	3
Love Potion #9	0	1	1	0	1	3
Bread and Roses	0	3	0	0	0	3
City of Women, The (Città delle donne, La)	0	2	0	0	1	3
Frankie and Johnny	0	1	1	1	0	3
Triumph of the Will (Triumph des Willens)	1	2	0	0	0	3
Center of the World, The	1	0	2	0	0	3
Girls Just Want to Have Fun	0	1	2	0	0	3
Navy Seals	0	0	1	1	1	3
Abominable Dr. Phibes, The	1	1	1	0	0	3
Lilies of the Field	0	3	0	0	0	3
Million Dollar Hotel, The	0	2	0	0	1	3
Making Mr. Right	0	0	1	1	1	3
Maid to Order	0	0	0	3	0	3
Like Father, Like Son	0	0	0	3	0	3
Hope and Glory	1	2	0	0	0	3
Back to the Beach	0	0	0	3	0	3
At Close Range	0	1	2	0	0	3
Claim, The	0	0	3	0	0	3
House of Mirth, The	0	0	2	0	1	3
She's Having a Baby	0	1	2	0	0	3
Bounty, The	0	0	3	0	0	3
Adventures of Ichabod and Mr. Toad, The	0	1	2	0	0	3
Billy Jack	0	0	2	1	0	3
Get Carter	0	2	1	0	0	3
Urban Legends: Final Cut	0	0	1	0	2	3
Crew, The	0	0	0	2	1	3
Phantasm IV: Oblivion	0	0	0	2	1	3
Phantasm II	1	0	0	1	1	3
Tampopo	1	1	1	0	0	3
Interiors	1	2	0	0	0	3
White Sands	0	0	3	0	0	3
In Crowd, The	0	1	1	0	1	3
The Golden Voyage of Sinbad	1	1	1	0	0	3
Thunderbolt and Lightfoot	0	1	2	0	0	3
Missing in Action 2: The Beginning	0	0	0	2	1	3
Kentucky Fried Movie, The	1	0	2	0	0	3
Boys and Girls	0	0	1	1	1	3
Paper Chase, The	0	3	0	0	0	3
Shaft	1	1	1	0	0	3
Soapdish	0	0	3	0	0	3
Action Jackson	0	0	0	2	1	3
Night of the Creeps	0	2	0	1	0	3
Endless Summer, The	2	0	1	0	0	3
8 ½ Women (a.k.a. 8 1/2 Women) (a.k.a. Eight and a Half Women)	0	1	2	0	0	3
Hamlet	0	1	2	0	0	3
Crow: Salvation, The	0	0	2	1	0	3
Limelight	0	2	1	0	0	3
Love and Basketball	0	1	2	0	0	3
Shakes the Clown	0	0	2	0	1	3
Where the Money Is	1	0	1	1	0	3
My Life	1	0	2	0	0	3
Lucas	0	2	0	1	0	3
Death Wish 2	0	0	0	2	1	3
School Daze	0	0	1	2	0	3
...And Justice for All	0	1	2	0	0	3
Mirror, The (Zerkalo)	1	2	0	0	0	3
Captain Horatio Hornblower R.N.	0	1	1	1	0	3
Nadine	0	0	3	0	0	3
Date with an Angel	0	0	0	1	2	3
Asphalt Jungle, The	0	3	0	0	0	3
Raisin in the Sun, A	0	3	0	0	0	3
What Planet Are You From?	1	0	1	1	0	3
Next Best Thing, The	0	1	0	1	1	3
Drowning Mona	0	0	0	1	2	3
Hanging Up	0	1	1	0	1	3
Tigger Movie, The	1	0	1	1	0	3
Where the Buffalo Roam	1	1	1	0	0	3
Star Is Born, A	0	2	1	0	0	3
Against All Odds	0	0	1	2	0	3
Snow Falling on Cedars	0	1	2	0	0	3
Angela's Ashes	0	1	2	0	0	3
Emperor and the Assassin, The (Jing ke ci qin wang)	0	2	1	0	0	3
Cradle Will Rock	0	1	2	0	0	3
Great Santini, The	0	2	1	0	0	3
Sweet and Lowdown	0	2	1	0	0	3
Holy Smoke	0	1	1	1	0	3
Shop Around the Corner, The	1	1	0	1	0	3
Repulsion	2	0	1	0	0	3
Poison Ivy: New Seduction	0	0	1	2	0	3
Felicia's Journey	0	1	2	0	0	3
Anywhere But Here	0	0	2	1	0	3
Under the Rainbow	0	0	1	1	1	3
Coma	0	2	1	0	0	3
Melvin and Howard	0	3	0	0	0	3
Indochine	1	2	0	0	0	3
Days of Heaven	0	2	1	0	0	3
Time of the Gypsies (Dom za vesanje)	1	2	0	0	0	3
Gulliver's Travels	1	0	1	0	1	3
Happy, Texas	1	1	1	0	0	3
Pajama Game, The	0	2	1	0	0	3
Minus Man, The	0	1	1	0	1	3
Iron Eagle IV	0	0	0	0	3	3
Aces: Iron Eagle III	0	0	1	1	1	3
Iron Eagle II	0	0	1	0	2	3
Pit and the Pendulum	1	1	0	1	0	3
Autumn Tale, An (Conte d'automne)	0	3	0	0	0	3
Dinner Game, The (Dîner de cons, Le)	1	2	0	0	0	3
Legend of 1900, The (a.k.a. The Legend of the Pianist on the Ocean) (Leggenda del pianista sull'oceano)	1	1	1	0	0	3
Limbo	0	3	0	0	0	3
Free Enterprise	0	1	2	0	0	3
Mummy, The	0	1	2	0	0	3
Mummy, The	0	2	0	1	0	3
Twin Dragons (Shuang long hui)	1	0	1	1	0	3
Dangerous Beauty	2	0	1	0	0	3
Baby Geniuses	0	0	0	2	1	3
Children of the Damned	0	2	0	1	0	3
Corruptor, The	0	0	2	1	0	3
Beyond the Poseidon Adventure	0	0	1	1	1	3
Earthquake	0	0	2	1	0	3
Avalanche	0	1	1	0	1	3
Meteor	0	0	1	1	1	3
Alligator	0	0	1	1	1	3
Airport	0	0	2	0	1	3
Pet Sematary II	0	0	2	0	1	3
Long Goodbye, The	2	1	0	0	0	3
Fantastic Planet, The (Planète sauvage, La)	2	0	1	0	0	3
Peeping Tom	1	1	0	0	1	3
Firewalker	1	0	1	1	0	3
52 Pick-Up	1	1	0	1	0	3
Tough Guys	0	1	1	1	0	3
Deadly Friend	0	0	0	2	1	3
Texas Chainsaw Massacre 2, The	0	0	1	1	1	3
Boy Who Could Fly, The	0	0	1	2	0	3
Virus	0	1	1	1	0	3
Hilary and Jackie	0	3	0	0	0	3
Affliction	0	1	2	0	0	3
Home Fries	0	0	1	2	0	3
Godzilla (Gojira)	0	0	2	0	1	3
Pope of Greenwich Village, The	0	0	2	0	1	3
Living Out Loud	0	1	1	1	0	3
Tales from the Darkside: The Movie	1	1	0	1	0	3
Mighty, The	0	2	1	0	0	3
Lodger: A Story of the London Fog, The	0	2	1	0	0	3
Man Who Knew Too Much, The	0	2	1	0	0	3
Family Plot	0	1	2	0	0	3
Air Bud: Golden Receiver	0	0	0	3	0	3
Clan of the Cave Bear, The	0	0	2	1	0	3
Maximum Overdrive	0	0	0	1	2	3
Halloween H20: 20 Years Later (Halloween 7: The Revenge of Laurie Strode)	0	1	2	0	0	3
Tall Tale	0	1	0	2	0	3
Steamboat Willie	0	1	0	1	1	3
Shaggy D.A., The	0	1	1	1	0	3
Night Porter, The (Portiere di notte, Il)	0	2	1	0	0	3
Herbie Goes to Monte Carlo	0	1	0	1	1	3
Condorman	0	2	0	1	0	3
Cat from Outer Space, The	0	0	2	0	1	3
Blackbeard's Ghost	1	0	2	0	0	3
Disturbing Behavior	0	0	0	3	0	3
Rapture, The	0	1	2	0	0	3
Halloween III: Season of the Witch	0	0	1	2	0	3
Friday the 13th Part VIII: Jason Takes Manhattan	0	0	1	1	1	3
Marty	0	3	0	0	0	3
Lost Weekend, The	0	3	0	0	0	3
Mrs. Miniver	1	1	1	0	0	3
You Can't Take It with You	1	1	1	0	0	3
Picnic at Hanging Rock	0	3	0	0	0	3
Henry Fool	1	0	1	1	0	3
Hope Floats	0	1	0	2	0	3
Taste of Cherry (Ta'm e guilass)	0	3	0	0	0	3
Kurt & Courtney	0	3	0	0	0	3
Last Days of Disco, The	2	1	0	0	0	3
Big One, The	0	2	1	0	0	3
Two Girls and a Guy	0	0	1	1	1	3
Wide Awake	0	2	1	0	0	3
Newton Boys, The	1	0	0	2	0	3
Twilight	0	0	1	2	0	3
Red Corner	1	0	2	0	0	3
Welcome to Sarajevo	0	1	1	1	0	3
Fast, Cheap & Out of Control	0	1	1	0	1	3
Playing God	0	0	2	1	0	3
MatchMaker, The	0	2	0	1	0	3
Fire Down Below	0	1	0	2	0	3
187 (One Eight Seven)	0	1	1	1	0	3
Kull the Conqueror	0	1	0	1	1	3
Money Talks	0	1	2	0	0	3
Hoodlum	0	0	1	2	0	3
Steel	0	0	2	0	1	3
Career Girls	1	2	0	0	0	3
Out to Sea	0	0	1	2	0	3
Buddy	0	0	1	2	0	3
Nowhere	0	2	1	0	0	3
Fathers' Day	0	0	0	1	2	3
Double Team	1	1	1	0	0	3
Daytrippers, The	0	2	1	0	0	3
Rosewood	0	2	0	1	0	3
Beautician and the Beast, The	0	0	1	1	1	3
Meet Wally Sparks	0	0	2	0	1	3
Underworld	0	1	2	0	0	3
Ghosts of Mississippi	0	2	0	1	0	3
Nightwatch	0	0	1	1	1	3
Blood and Wine (Blood & Wine)	0	0	1	2	0	3
Bride of Frankenstein, The (Bride of Frankenstein)	0	1	2	0	0	3
Believers, The	0	2	1	0	0	3
Amityville: Dollhouse	0	0	0	1	2	3
Amityville 3-D	0	0	0	2	1	3
Amityville 1992: It's About Time	0	0	0	2	1	3
Trust	1	2	0	0	0	3
Double Life of Veronique, The (Double Vie de Véronique, La)	1	1	1	0	0	3
Tin Drum, The (Blechtrommel, Die)	0	3	0	0	0	3
Return of Martin Guerre, The (Retour de Martin Guerre, Le)	1	2	0	0	0	3
Children of the Corn IV: The Gathering	2	1	0	0	0	3
Trees Lounge	1	1	1	0	0	3
Extreme Measures	0	1	0	2	0	3
Set It Off	1	0	0	2	0	3
To Be or Not to Be	0	1	1	0	1	3
Lost Horizon	0	3	0	0	0	3
Band Wagon, The	1	1	1	0	0	3
Women, The	0	3	0	0	0	3
Mother Night	1	0	2	0	0	3
Land Before Time III: The Time of the Great Giving	0	0	2	0	1	3
Kansas City	0	2	1	0	0	3
Foxfire	0	2	1	0	0	3
Stupids, The	0	1	2	0	0	3
Heaven's Prisoners	0	1	2	0	0	3
Horseman on the Roof, The (Hussard sur le toit, Le)	0	2	1	0	0	3
Mrs. Winterbourne	0	1	2	0	0	3
Underground	2	1	0	0	0	3
Flower of My Secret, The (La flor de mi secreto)	0	1	1	1	0	3
Kika	0	0	1	1	1	3
Simple Twist of Fate, A	0	1	2	0	0	3
Scout, The	0	0	1	2	0	3
Romeo Is Bleeding	0	1	2	0	0	3
Life with Mikey	0	1	1	1	0	3
Getting Even with Dad	0	0	2	1	0	3
Widows' Peak	0	1	1	1	0	3
Blue Chips	0	0	1	1	1	3
To Live (Huozhe)	1	1	1	0	0	3
Swan Princess, The	0	1	2	0	0	3
Roommates	1	1	0	1	0	3
Poison Ivy II	0	0	1	2	0	3
New Jersey Drive	1	1	0	1	0	3
Hunted, The	0	1	2	0	0	3
Destiny Turns on the Radio	0	0	2	0	1	3
Bushwhacked	0	2	0	1	0	3
White Man's Burden	0	1	2	0	0	3
Doom Generation, The	0	1	1	1	0	3
Blue in the Face	0	2	0	1	0	3
Amazing Panda Adventure, The	0	1	2	0	0	3
Before and After	0	1	2	0	0	3
Unforgettable	0	0	3	0	0	3
Crossing Guard, The	0	1	2	0	0	3
Big Green, The	0	1	0	1	1	3
Shanghai Triad (Yao a yao yao dao waipo qiao)	0	2	0	0	1	3
Lassie	1	0	0	0	1	2
Juliet of the Spirits (Giulietta degli spiriti)	0	1	1	0	0	2
National Velvet	0	2	0	0	0	2
Public Enemy, The	1	1	0	0	0	2
Little Women	0	2	0	0	0	2
What's New, Pussycat	0	1	1	0	0	2
Follow the Fleet	0	2	0	0	0	2
The Infiltrator	0	2	0	0	0	2
Au Hasard Balthazar	0	2	0	0	0	2
Tokyo Drifter (Tôkyô nagaremono)	0	2	0	0	0	2
Radio Flyer	0	0	2	0	0	2
Point Blank	0	0	2	0	0	2
Asterix and Cleopatra (Astérix et Cléopâtre)	1	1	0	0	0	2
Midnight Clear, A	1	0	1	0	0	2
Diamond Arm, The (Brilliantovaya ruka)	1	0	1	0	0	2
Project X	0	1	0	1	0	2
Yours, Mine and Ours	0	0	2	0	0	2
They Call Me Trinity	1	0	1	0	0	2
Housesitter	0	0	1	1	0	2
Hoffa	0	0	2	0	0	2
Hard Way, The	1	0	0	1	0	2
Guarding Tess	0	1	0	1	0	2
Ordet (Word, The)	0	2	0	0	0	2
Holy Mountain, The (Montaña sagrada, La)	1	1	0	0	0	2
Desk Set	0	2	0	0	0	2
Devil's Playground	1	1	0	0	0	2
The Edge of Seventeen	0	1	1	0	0	2
Looney Tunes: Back in Action	0	1	0	1	0	2
My Architect: A Son's Journey	1	1	0	0	0	2
Unvanquished, The (Aparajito)	0	2	0	0	0	2
Eye, The (Gin gwai) (Jian gui)	0	1	1	0	0	2
Interstate 60	0	2	0	0	0	2
Clonus Horror, The	1	0	0	0	1	2
Snake in the Eagle's Shadow (Se ying diu sau)	0	1	1	0	0	2
Brother Bear	0	0	2	0	0	2
Hitch Hikers Guide to the Galaxy, The	1	1	0	0	0	2
Veronica Guerin	0	1	1	0	0	2
Cloak & Dagger	0	1	1	0	0	2
Ewok Adventure, The (a.k.a. Caravan of Courage: An Ewok Adventure)	0	0	1	1	0	2
Times of Harvey Milk, The	2	0	0	0	0	2
Out of Time	0	2	0	0	0	2
Knife in the Water (Nóz w wodzie)	0	2	0	0	0	2
Yankee Doodle Dandy	0	2	0	0	0	2
Ewoks: The Battle for Endor	0	1	1	0	0	2
Gas, Food, Lodging	0	1	0	1	0	2
Police Story (Ging chaat goo si)	1	1	0	0	0	2
Quiet Earth, The	1	1	0	0	0	2
Come and See (Idi i smotri)	2	0	0	0	0	2
Rookie, The	0	0	1	1	0	2
Spies Like Us	0	1	0	1	0	2
'Round Midnight	0	2	0	0	0	2
Bugsy Malone	0	0	2	0	0	2
Chinese Ghost Story, A (Sinnui yauwan)	1	1	0	0	0	2
Better Tomorrow II, A (Ying hung boon sik II)	1	0	1	0	0	2
Brief History of Time, A	0	1	1	0	0	2
Alice (Neco z Alenky)	1	0	1	0	0	2
My Life Without Me	0	2	0	0	0	2
Lonesome Dove	0	2	0	0	0	2
In This World	0	0	2	0	0	2
Bullet in the Head	1	0	1	0	0	2
Memoirs of an Invisible Man	0	0	0	2	0	2
Hello, Dolly!	1	0	1	0	0	2
Nuns on the Run	0	0	1	1	0	2
Once Upon a Time in China III (Wong Fei-hung tsi sam: Siwong tsangba)	0	1	0	1	0	2
Kuffs	0	0	1	1	0	2
State of Grace	0	2	0	0	0	2
Quigley Down Under	0	1	1	0	0	2
Death in Venice (Morte a Venezia)	0	2	0	0	0	2
Comic Book Villains	0	0	1	1	0	2
Captain America	0	0	0	1	1	2
City Hunter (Sing si lip yan)	0	1	0	1	0	2
Sidekicks	0	0	0	2	0	2
Barbarians at the Gate	0	0	2	0	0	2
Man's Best Friend	0	0	0	2	0	2
Grind	0	1	0	1	0	2
My Father the Hero	0	0	1	1	0	2
Brother's Keeper	1	1	0	0	0	2
Private Life of Sherlock Holmes, The	0	0	1	1	0	2
One, Two, Three	1	1	0	0	0	2
Kickboxer 2: The Road Back	0	1	1	0	0	2
Scorched	0	1	1	0	0	2
Camp	1	0	0	1	0	2
Garage Days	0	0	0	1	1	2
Boxer, The	0	1	1	0	0	2
Northfork	0	0	1	1	0	2
Lion King II: Simba's Pride, The	0	0	2	0	0	2
Tenant, The (Locataire, Le)	1	1	0	0	0	2
Mr. Baseball	0	0	1	1	0	2
Babe, The	0	0	1	1	0	2
Ali: Fear Eats the Soul (Angst essen Seele auf)	0	2	0	0	0	2
Who Am I? (Wo shi shei)	0	1	1	0	0	2
Good Burger	0	1	0	0	1	2
Flight of the Phoenix, The	0	2	0	0	0	2
Belle époque	2	0	0	0	0	2
Two Mules for Sister Sara	0	0	2	0	0	2
6th Man, The (Sixth Man, The)	0	0	0	1	1	2
Destry Rides Again	0	2	0	0	0	2
Car Wash	1	0	1	0	0	2
Treasure Island	0	1	1	0	0	2
Wrong Turn	0	1	1	0	0	2
Kirikou and the Sorceress (Kirikou et la sorcière)	0	2	0	0	0	2
Respiro	1	0	1	0	0	2
Storks	1	1	0	0	0	2
10th Kingdom, The	1	0	0	0	1	2
High Society	0	0	2	0	0	2
Jalla! Jalla!	0	2	0	0	0	2
Blood: The Last Vampire	0	1	1	0	0	2
People I Know	0	1	1	0	0	2
It Runs in the Family	0	0	2	0	0	2
Scenes from a Mall	0	0	0	1	1	2
Calendar Girl	1	0	1	0	0	2
Undercover Blues	0	0	0	2	0	2
Sibling Rivalry	0	0	1	1	0	2
Cube 2: Hypercube	1	0	1	0	0	2
Blue Sky	0	2	0	0	0	2
Fubar	1	0	1	0	0	2
Dead End	0	1	1	0	0	2
Sound of Thunder, A	0	1	0	1	0	2
Lion King 1½, The	2	0	0	0	0	2
Man Apart, A	0	0	1	1	0	2
Stevie	1	1	0	0	0	2
Raising Victor Vargas	0	2	0	0	0	2
Head of State	0	1	0	0	1	2
Brown Bunny, The	0	1	1	0	0	2
Basic	0	2	0	0	0	2
Awful Truth, The	2	0	0	0	0	2
Bring It On Again	0	0	0	2	0	2
Salaam Bombay!	0	1	1	0	0	2
Journey to the Center of the Earth	0	0	2	0	0	2
13th	2	0	0	0	0	2
Spun	0	1	1	0	0	2
Safety of Objects, The	1	0	0	1	0	2
Nowhere in Africa (Nirgendwo in Afrika)	0	2	0	0	0	2
Keeping Up with the Joneses	0	2	0	0	0	2
Life Stinks	0	0	0	2	0	2
Stone Reader	0	2	0	0	0	2
Being Human	0	0	2	0	0	2
Black Stallion Returns, The	0	0	1	1	0	2
All the Real Girls	1	1	0	0	0	2
Intimate Strangers (Confidences trop intimes)	1	0	1	0	0	2
Zapped!	0	0	0	2	0	2
Trail of the Pink Panther	0	1	0	1	0	2
Tenebre	0	1	0	0	1	2
Savannah Smiles	0	1	0	1	0	2
Richard Pryor Live on the Sunset Strip	1	0	1	0	0	2
Pirate Movie, The	0	1	0	1	0	2
Firefox	0	1	0	1	0	2
Starship Troopers 2: Hero of the Federation	0	0	0	1	1	2
Guru, The	0	1	0	1	0	2
Sugar Hill	0	1	0	0	1	2
8 Seconds	0	1	0	1	0	2
Story of the Weeping Camel, The (Geschichte vom weinenden Kamel, Die)	0	2	0	0	0	2
Pépé le Moko	0	1	1	0	0	2
Imitation of Life	0	1	1	0	0	2
Band of Outsiders (Bande à part)	0	1	1	0	0	2
Mean Creek	1	0	1	0	0	2
Kangaroo Jack	0	0	1	0	1	2
Yes Men, The	0	2	0	0	0	2
Azumi	0	1	0	1	0	2
The True Memoirs of an International Assassin	0	1	1	0	0	2
Heavy Metal 2000	0	0	1	1	0	2
What the #$*! Do We Know!? (a.k.a. What the Bleep Do We Know!?)	0	0	2	0	0	2
Nicholas Nickleby	0	2	0	0	0	2
Gozu (Gokudô kyôfu dai-gekijô: Gozu)	2	0	0	0	0	2
Assassination of Richard Nixon, The	0	2	0	0	0	2
Fat Albert	0	0	0	2	0	2
Story of O, The (Histoire d'O)	0	1	1	0	0	2
Black Christmas	0	1	1	0	0	2
Children's Hour, The	0	2	0	0	0	2
Stander	0	1	1	0	0	2
Intact (Intacto)	1	1	0	0	0	2
Imaginary Heroes	0	1	1	0	0	2
Deathtrap	1	1	0	0	0	2
Burden of Dreams	0	2	0	0	0	2
Beast Within, The	0	0	0	2	0	2
Android	1	1	0	0	0	2
Victory (a.k.a. Escape to Victory)	2	0	0	0	0	2
Last Seduction, The	0	1	1	0	0	2
Elling	1	1	0	0	0	2
Boogeyman	0	0	1	1	0	2
Extreme Ops	0	0	0	2	0	2
Nobody Knows (Dare mo shiranai)	1	1	0	0	0	2
Employee of the Month	0	0	1	1	0	2
Thief	1	1	0	0	0	2
Scanners	0	1	1	0	0	2
Colonel Chabert, Le	1	1	0	0	0	2
Boys Life	0	1	0	1	0	2
Steamboy (Suchîmubôi)	0	0	2	0	0	2
Bride & Prejudice	0	1	1	0	0	2
HyperNormalisation	1	1	0	0	0	2
My Dinner with André	2	0	0	0	0	2
Happy Birthday to Me	0	0	0	2	0	2
Faces of Death	0	0	0	2	0	2
Banana Joe	0	0	2	0	0	2
Absence of Malice	0	1	1	0	0	2
Staying Alive	0	0	1	1	0	2
Tully	0	1	0	1	0	2
Real Women Have Curves	1	1	0	0	0	2
Grey Zone, The	0	1	1	0	0	2
Bad Company	0	1	1	0	0	2
Pokemon 4 Ever (a.k.a. Pokémon 4: The Movie)	0	0	0	0	2	2
Comedian	0	0	2	0	0	2
Tuck Everlasting	0	1	1	0	0	2
Whiplash	2	0	0	0	0	2
Flirting	1	1	0	0	0	2
Welcome to Collinwood	0	0	1	1	0	2
Heaven	0	2	0	0	0	2
Sword of Doom, The (Dai-bosatsu tôge)	1	1	0	0	0	2
Trials of Henry Kissinger, The	0	2	0	0	0	2
Four Feathers, The	0	1	0	1	0	2
A Silent Voice	1	0	1	0	0	2
Ballistic: Ecks vs. Sever	0	0	1	1	0	2
Pom Poko (a.k.a. Raccoon War, The) (Heisei tanuki gassen pompoko)	1	1	0	0	0	2
Lavender Hill Mob, The	1	1	0	0	0	2
Suburban Commando	0	0	1	0	1	2
Hills Have Eyes, The	0	2	0	0	0	2
Wild Parrots of Telegraph Hill, The	2	0	0	0	0	2
Last House on the Left, The	0	1	1	0	0	2
Swimfan	0	1	0	0	1	2
Miss Sloane	1	1	0	0	0	2
Swarm, The	0	0	1	1	0	2
Care Bears Movie II: A New Generation	0	0	0	1	1	2
Care Bears Movie, The	0	0	0	1	1	2
Undisputed	0	0	2	0	0	2
Brothers (Brødre)	1	1	0	0	0	2
Serving Sara	0	1	1	0	0	2
Ivan's Childhood (a.k.a. My Name is Ivan) (Ivanovo detstvo)	1	0	0	0	1	2
Principal, The	0	1	1	0	0	2
Secret Ballot (Raye makhfi)	0	1	1	0	0	2
The Founder	1	1	0	0	0	2
Mutant Aliens	1	0	1	0	0	2
Robin and Marian	0	1	1	0	0	2
Who Is Cletis Tout?	0	0	2	0	0	2
Assassin's Creed	0	1	0	1	0	2
Mysterious Skin	0	1	0	0	1	2
Mrs. Parker and the Vicious Circle	0	2	0	0	0	2
1776	0	1	1	0	0	2
Crocodile Hunter: Collision Course, The	0	0	1	1	0	2
Mo' Money	0	0	1	1	0	2
Divorce - Italian Style (Divorzio all'italiana)	1	1	0	0	0	2
Sunshine State	0	1	1	0	0	2
Adventures of Sharkboy and Lavagirl 3-D, The	0	0	1	0	1	2
Juwanna Mann	0	0	0	1	1	2
High Tension (Haute tension) (Switchblade Romance)	0	2	0	0	0	2
Eddie Izzard: Dress to Kill	1	1	0	0	0	2
Wonderful, Horrible Life of Leni Riefenstahl, The (Macht der Bilder: Leni Riefenstahl, Die)	0	2	0	0	0	2
Quo Vadis	0	1	1	0	0	2
Dark Blue World (Tmavomodrý svet)	1	1	0	0	0	2
Perfect Man, The	0	0	2	0	0	2
Rapid Fire	0	2	0	0	0	2
Beat That My Heart Skipped, The (battre mon coeur s'est arrêté, De)	0	0	2	0	0	2
Requiem for a Heavyweight	0	2	0	0	0	2
Monkey Business	0	1	0	1	0	2
Spirit: Stallion of the Cimarron	0	1	1	0	0	2
Last Days	0	1	0	1	0	2
White Fang	0	0	0	2	0	2
Iron Will	0	1	1	0	0	2
Deuces Wild	0	0	1	1	0	2
Wild Orchid	0	0	1	0	1	2
Lenny	0	2	0	0	0	2
Cadillac Man	0	0	0	1	1	2
Life or Something Like It	0	1	0	1	0	2
Hidden (a.k.a. Cache) (Caché)	0	1	0	1	0	2
Kin-Dza-Dza!	0	2	0	0	0	2
Rome, Open City (a.k.a. Open City) (Roma, città aperta)	0	2	0	0	0	2
Cry_Wolf (a.k.a. Cry Wolf)	0	0	1	1	0	2
Police Story 2 (Ging chaat goo si juk jaap)	1	0	1	0	0	2
Cat's Meow, The	0	0	1	1	0	2
Atomic Cafe, The	1	1	0	0	0	2
High Crimes	0	1	1	0	0	2
Impromptu	1	1	0	0	0	2
Woyzeck	0	1	1	0	0	2
Into the Blue	0	0	1	1	0	2
George Washington	0	0	0	2	0	2
Stolen Summer	0	0	2	0	0	2
Goal! The Dream Begins (Goal!)	1	1	0	0	0	2
Return of the Secaucus 7	0	2	0	0	0	2
All the Right Moves	0	0	1	1	0	2
Promises	1	1	0	0	0	2
Great Yokai War, The (Yôkai daisensô)	0	1	0	1	0	2
Dead Man's Shoes	2	0	0	0	0	2
Motel Hell	0	1	0	1	0	2
Mon oncle d'Amérique	0	1	1	0	0	2
Crooklyn	0	0	1	1	0	2
Hangar 18	1	1	0	0	0	2
Magnificent Ambersons, The	0	1	1	0	0	2
All About the Benjamins	0	0	1	1	0	2
Zombie (a.k.a. Zombie 2: The Dead Are Among Us) (Zombi 2)	0	2	0	0	0	2
	0	1	0	0	1	2
C.R.A.Z.Y.	0	2	0	0	0	2
Sarah Silverman: Jesus Is Magic	0	0	1	1	0	2
Wendigo	0	1	0	1	0	2
Mean Machine	0	1	1	0	0	2
How to Kill Your Neighbor's Dog	1	0	0	1	0	2
Beauty and the Beast	0	1	1	0	0	2
After the Fox (Caccia alla volpe)	0	0	2	0	0	2
Paradise Now	0	2	0	0	0	2
Havoc	0	0	2	0	0	2
Baby's Day Out	0	0	0	1	1	2
Mrs. Henderson Presents	0	1	0	0	1	2
Luxo Jr.	1	0	1	0	0	2
Rare Birds	0	1	1	0	0	2
Ghost in the Shell	0	2	0	0	0	2
Escaflowne: The Movie (Escaflowne)	0	1	1	0	0	2
Seconds	0	1	1	0	0	2
Glory Road	1	0	1	0	0	2
Italian for Beginners (Italiensk for begyndere)	0	0	2	0	0	2
Project A ('A' gai waak)	1	0	1	0	0	2
Russia House, The	0	0	1	1	0	2
Annapolis	0	0	2	0	0	2
Waterdance, The	0	2	0	0	0	2
Charlotte Gray	0	2	0	0	0	2
Curious George	0	1	1	0	0	2
Pulse	0	0	0	2	0	2
Ultimate Avengers	0	0	2	0	0	2
Double Happiness	0	2	0	0	0	2
Aquamarine	0	0	1	0	1	2
Spacehunter: Adventures in the Forbidden Zone	0	0	1	0	1	2
Sheena	0	0	0	1	1	2
Kandahar (Safar e Ghandehar)	0	2	0	0	0	2
Shaggy Dog, The	0	0	0	1	1	2
Take the Lead	1	0	1	0	0	2
Business of Strangers, The	0	1	1	0	0	2
Affair of the Necklace, The	0	1	1	0	0	2
Sudden Impact	1	0	0	1	0	2
Gauntlet, The	0	1	1	0	0	2
Reefer Madness: The Movie Musical	2	0	0	0	0	2
Candy	1	1	0	0	0	2
Subway	0	2	0	0	0	2
Sentinel, The	0	1	0	1	0	2
Jabberwocky	0	2	0	0	0	2
Incredible Shrinking Woman, The	0	0	0	2	0	2
American Haunting, An	0	0	0	1	1	2
Down in the Valley	0	1	1	0	0	2
Notorious Bettie Page, The	0	0	2	0	0	2
When a Stranger Calls	0	0	1	1	0	2
Garfield: A Tail of Two Kitties	0	1	0	0	1	2
Metal: A Headbanger's Journey	1	1	0	0	0	2
Female Trouble	1	0	0	1	0	2
Denis Leary: No Cure for Cancer	0	1	1	0	0	2
Ant Bully, The	0	1	1	0	0	2
Underneath	0	1	1	0	0	2
Fat Girl (À ma soeur!)	0	1	1	0	0	2
Mind Game	1	1	0	0	0	2
Competition, The	0	2	0	0	0	2
Big Red One, The	1	1	0	0	0	2
Tom & Viv	0	0	2	0	0	2
Quadrophenia	0	1	0	1	0	2
Little Foxes, The	0	2	0	0	0	2
Grass Is Greener, The	0	1	1	0	0	2
Mulholland Dr.	1	0	1	0	0	2
French Lieutenant's Woman, The	0	0	2	0	0	2
Sidewalks of New York	0	0	1	1	0	2
Liam	0	0	0	2	0	2
Glass House, The	0	0	2	0	0	2
Musketeer, The	0	0	0	1	1	2
Gridiron Gang	0	0	2	0	0	2
3 Ninjas Kick Back	0	0	0	1	1	2
Tortilla Soup	0	1	1	0	0	2
Conversations with Other Women	1	0	1	0	0	2
Open Season	0	0	2	0	0	2
Texas Chainsaw Massacre: The Beginning, The	0	0	1	1	0	2
Strawberry and Chocolate (Fresa y chocolate)	0	2	0	0	0	2
Marine, The	0	0	2	0	0	2
Infamous	0	2	0	0	0	2
Fellini's Casanova (Il Casanova di Federico Fellini)	0	2	0	0	0	2
Feast	0	0	2	0	0	2
Deliver Us from Evil	1	1	0	0	0	2
Any Which Way You Can	0	0	0	2	0	2
Theremin: An Electronic Odyssey	0	2	0	0	0	2
Marat/Sade	1	1	0	0	0	2
Catch a Fire	0	1	1	0	0	2
Death of a President	0	1	1	0	0	2
Santa Clause 3: The Escape Clause, The	0	1	0	1	0	2
Original Sin	0	1	0	1	0	2
Cotton Club, The	0	1	1	0	0	2
Wizard, The	0	1	1	0	0	2
The Great Train Robbery	0	1	0	0	1	2
Nativity Story, The	0	2	0	0	0	2
Tall Guy, The	0	1	0	1	0	2
Sea of Love	0	0	2	0	0	2
We Are Marshall	0	2	0	0	0	2
History Boys, The	0	0	2	0	0	2
DOA: Dead or Alive	0	0	1	0	1	2
Penn & Teller Get Killed	1	0	1	0	0	2
Package, The	0	1	1	0	0	2
Next of Kin	0	0	0	2	0	2
Stomp the Yard	0	0	2	0	0	2
Miracle Mile	0	1	1	0	0	2
Miss Potter	0	2	0	0	0	2
Loverboy	0	0	1	1	0	2
Venus	0	1	1	0	0	2
Little Monsters	0	0	1	1	0	2
Let It Ride	1	0	0	1	0	2
Innocent Man, An	0	0	1	1	0	2
Gross Anatomy (a.k.a. A Cut Above)	0	1	1	0	0	2
Great Balls of Fire!	0	0	1	1	0	2
Family Business	0	0	1	1	0	2
Eddie and the Cruisers	0	0	1	0	1	2
Hitcher, The	0	0	2	0	0	2
Cyborg	0	0	0	0	2	2
Chances Are	0	1	0	1	0	2
Blind Fury	0	1	1	0	0	2
American Ninja	0	0	1	1	0	2
49 Up	0	2	0	0	0	2
Catch and Release	0	0	1	1	0	2
Blood and Chocolate	0	0	0	2	0	2
Messengers, The	0	0	1	1	0	2
Serpent and the Rainbow, The	0	1	1	0	0	2
Boss of It All, The (Direktøren for det hele)	2	0	0	0	0	2
Return to Snowy River (a.k.a. The Man From Snowy River II)	0	0	1	1	0	2
Cocaine Cowboys	1	1	0	0	0	2
Astronaut Farmer, The	0	0	1	1	0	2
Night in the Life of Jimmy Reardon, A	0	0	1	1	0	2
Milagro Beanfield War	0	1	1	0	0	2
It's a Boy Girl Thing	0	0	0	0	2	2
Lady in White (a.k.a. The Mystery of the Lady in White)	0	0	1	0	1	2
Johnny Be Good	0	1	0	1	0	2
Reno 911!: Miami	0	1	0	1	0	2
Camille Claudel	0	2	0	0	0	2
Biloxi Blues	0	1	1	0	0	2
2001 Maniacs	0	1	1	0	0	2
Perez Family, The	0	0	2	0	0	2
	1	1	0	0	0	2
Ariel	0	1	0	1	0	2
Above the Law	0	0	1	1	0	2
18 Again!	0	0	0	1	1	2
Last Mimzy, The	0	1	1	0	0	2
Priceless (Hors de prix)	1	1	0	0	0	2
Dead Silence	0	1	1	0	0	2
Outland	0	0	2	0	0	2
Big Boss, The (Fists of Fury) (Tang shan da xiong)	1	0	1	0	0	2
Hills Have Eyes II, The	0	0	1	1	0	2
Written on the Wind	1	1	0	0	0	2
Moby Dick	1	1	0	0	0	2
Misfits, The	0	1	1	0	0	2
Kiss Me Deadly	1	0	1	0	0	2
Cries and Whispers (Viskningar och rop)	0	2	0	0	0	2
Thing with Two Heads, The	0	0	0	0	2	2
Hoax, The	0	2	0	0	0	2
Fall of the House of Usher, The (House of Usher)	0	0	2	0	0	2
Diary of a Chambermaid (Journal d'une femme de chambre, Le)	0	2	0	0	0	2
Cannonball Run II	0	0	1	1	0	2
Rape Me (Baise-moi)	0	1	1	0	0	2
Vie en Rose, La (Môme, La)	0	1	1	0	0	2
Vacancy	0	2	0	0	0	2
In the Land of Women	0	2	0	0	0	2
It's a Very Merry Muppet Christmas Movie	0	0	1	0	1	2
Day Watch (Dnevnoy dozor)	0	0	1	1	0	2
Wheels on Meals (Kuai can che)	1	0	1	0	0	2
Librarian: Return to King Solomon's Mines, The	0	2	0	0	0	2
Librarian: Quest for the Spear, The	0	2	0	0	0	2
I'm a Cyborg, But That's OK (Saibogujiman kwenchana)	0	0	2	0	0	2
Youngblood	0	0	0	2	0	2
Forgotten Silver	1	1	0	0	0	2
TV Set, The	0	2	0	0	0	2
Sand Pebbles, The	0	1	1	0	0	2
First Snow	0	1	1	0	0	2
Manufactured Landscapes	0	2	0	0	0	2
Okja	0	2	0	0	0	2
Ice Castles	0	0	1	1	0	2
Man Who Cried, The	0	2	0	0	0	2
Himalaya (Himalaya - l'enfance d'un chef)	0	1	1	0	0	2
No Reservations	0	1	1	0	0	2
My Family	0	0	2	0	0	2
Sydney White	0	1	0	1	0	2
Rififi (Du rififi chez les hommes)	2	0	0	0	0	2
Pelle the Conqueror (Pelle erobreren)	0	2	0	0	0	2
Love Story	0	1	0	1	0	2
5,000 Fingers of Dr. T, The	1	0	1	0	0	2
Rocket Science	0	1	1	0	0	2
Norma Rae	0	1	1	0	0	2
Miami Rhapsody	0	0	0	1	1	2
Invasion, The	0	1	0	1	0	2
Rough Night	1	0	0	1	0	2
Lost in America	0	1	0	0	1	2
Under the Sand	1	1	0	0	0	2
Town & Country	0	0	1	1	0	2
Days of Wine and Roses	0	2	0	0	0	2
Circle, The (Dayereh)	0	1	1	0	0	2
Brave One, The	0	1	1	0	0	2
We Own the Night	0	2	0	0	0	2
Elizabeth: The Golden Age	0	0	2	0	0	2
Sleuth	1	1	0	0	0	2
Comebacks, The	0	0	0	0	2	2
Exit Wounds	0	0	2	0	0	2
The Jane Austen Book Club	0	2	0	0	0	2
4 Little Girls	1	1	0	0	0	2
For the Bible Tells Me So	0	1	1	0	0	2
Double Impact	1	0	0	1	0	2
Saved by the Bell: Hawaiian Style	0	0	2	0	0	2
Fantasticks, The	0	2	0	0	0	2
Elmer Gantry	0	2	0	0	0	2
Lions For Lambs	1	0	1	0	0	2
Southland Tales	0	0	2	0	0	2
Evening with Kevin Smith 2: Evening Harder, An	0	1	0	1	0	2
Series 7: The Contenders	0	0	1	1	0	2
Caveman's Valentine, The	0	1	1	0	0	2
I'm Not There	0	1	1	0	0	2
Recess: School's Out	0	2	0	0	0	2
Vatel	1	1	0	0	0	2
Wrong Turn 2: Dead End	0	1	0	1	0	2
Maxed Out: Hard Times, Easy Credit and the Era of Predatory Lenders	0	1	1	0	0	2
Nico and Dani (Krámpack)	0	2	0	0	0	2
Left Behind: The Movie	1	1	0	0	0	2
My Demon Lover	0	0	0	0	2	2
My Crazy Life (Mi vida loca)	0	0	2	0	0	2
Leonard Part 6	0	0	0	0	2	2
Like Stars on Earth (Taare Zameen Par)	1	1	0	0	0	2
Glass Menagerie, The	0	1	0	1	0	2
Cherry 2000	0	0	1	1	0	2
Strange Wilderness	0	1	1	0	0	2
World on a Wire (Welt am Draht)	0	2	0	0	0	2
Barfly	1	0	0	1	0	2
Baby Boom	0	1	1	0	0	2
Amazon Women on the Moon	1	1	0	0	0	2
With a Friend Like Harry... (Harry, un ami qui vous veut du bien)	1	1	0	0	0	2
Step Up 2 the Streets	0	1	1	0	0	2
The Man in the Moon	1	0	1	0	0	2
Panic	1	0	1	0	0	2
Double Take	0	0	1	1	0	2
Zeitgeist: The Movie	1	0	1	0	0	2
Justice League: The New Frontier	0	0	2	0	0	2
Class, The (Klass)	1	0	0	1	0	2
Drillbit Taylor	1	0	0	1	0	2
Despicable Me 3	0	1	0	0	1	2
Smart People	0	0	2	0	0	2
All the Pretty Horses	0	0	1	1	0	2
Zebraman	0	1	1	0	0	2
Stop-Loss	0	1	1	0	0	2
Nim's Island	0	1	1	0	0	2
Outpost	0	0	1	1	0	2
Super High Me	1	1	0	0	0	2
Talk Radio	0	0	2	0	0	2
Prom Night	0	0	0	0	2	2
American Pie Presents Beta House (American Pie 6: Beta House)	0	0	2	0	0	2
Girl Next Door, The	0	2	0	0	0	2
One Day in September	1	1	0	0	0	2
Young People Fucking (a.k.a. YPF)	0	1	0	0	1	2
Kit Kittredge: An American Girl	0	1	0	1	0	2
Gonzo: The Life and Work of Dr. Hunter S. Thompson	0	2	0	0	0	2
Welcome to the Sticks (Bienvenue chez les Ch'tis)	1	1	0	0	0	2
Private Eyes, The	0	0	2	0	0	2
Meet Dave	1	0	1	0	0	2
Machine Girl, The (Kataude mashin gâru)	0	0	1	1	0	2
Detour	0	2	0	0	0	2
Unsinkable Molly Brown, The	0	2	0	0	0	2
Felon	0	1	1	0	0	2
The Godfather Trilogy: 1972-1990	2	0	0	0	0	2
Slumber Party Massacre, The	0	1	0	1	0	2
Zone, The (La Zona)	0	2	0	0	0	2
Invisible Man, The	0	1	1	0	0	2
Bank Dick, The	0	0	1	1	0	2
Beautiful	0	1	0	0	1	2
Rocker, The	0	1	0	1	0	2
Under Suspicion	0	0	1	1	0	2
Duets	0	1	1	0	0	2
Bait	0	1	0	1	0	2
Spirit, The	0	0	2	0	0	2
Art of War, The	0	0	1	0	1	2
John Adams	0	2	0	0	0	2
Bangkok Dangerous	0	1	1	0	0	2
Lakeview Terrace	0	1	1	0	0	2
Ghost Town	0	1	0	0	1	2
About Adam	0	2	0	0	0	2
Eyes of Tammy Faye, The	0	2	0	0	0	2
Affair of Love, An (Liaison pornographique, Une)	2	0	0	0	0	2
The Spiral Staircase	0	2	0	0	0	2
Rachel Getting Married	0	1	0	1	0	2
20,000 Leagues Under the Sea	0	2	0	0	0	2
Bronco Billy	0	0	2	0	0	2
Brain That Wouldn't Die, The	0	0	0	1	1	2
Psycho Beach Party	0	0	1	0	1	2
Pride and Glory	0	1	1	0	0	2
Wonderland	0	2	0	0	0	2
Tin Man	0	0	1	1	0	2
JCVD	0	1	1	0	0	2
Crows Zero (Kurôzu zero)	1	1	0	0	0	2
Chuck & Buck	0	0	1	1	0	2
Class, The (Entre les murs)	0	0	2	0	0	2
Groove	0	2	0	0	0	2
Shower (Xizao)	1	0	1	0	0	2
Igor	0	2	0	0	0	2
Hunger	2	0	0	0	0	2
Shrek the Halls	0	0	1	1	0	2
House Party	0	0	1	0	1	2
Braddock: Missing in Action III	0	0	0	1	1	2
Hot Spot, The	0	0	2	0	0	2
War of the Worlds	0	1	1	0	0	2
Communion	0	1	1	0	0	2
Blackadder Back & Forth	0	1	1	0	0	2
Jesus' Son	0	1	1	0	0	2
Butterfly (La lengua de las mariposas)	1	0	1	0	0	2
The Square	1	1	0	0	0	2
Sugarland Express, The	0	1	0	1	0	2
Far From Home: The Adventures of Yellow Dog	1	0	1	0	0	2
American Pop	0	1	1	0	0	2
Love's Labour's Lost	0	1	0	1	0	2
Push	0	1	1	0	0	2
Burglar	0	1	0	1	0	2
International, The	0	0	2	0	0	2
Berlin Calling	1	1	0	0	0	2
Divo, Il	0	2	0	0	0	2
Friday the 13th	0	0	2	0	0	2
Pink Panther 2, The	0	1	0	1	0	2
Toxic Avenger Part III: The Last Temptation of Toxie, The	0	0	1	0	1	2
Toxic Avenger, Part II, The	0	0	1	0	1	2
Cottage, The	1	1	0	0	0	2
Haunting in Connecticut, The	0	0	1	1	0	2
Big Stan	0	0	2	0	0	2
Anvil! The Story of Anvil	0	2	0	0	0	2
Decline of Western Civilization, The	0	2	0	0	0	2
Damned United, The	1	1	0	0	0	2
Benji the Hunted	1	1	0	0	0	2
Young Victoria, The	1	1	0	0	0	2
Puppet Master III: Toulon's Revenge	0	0	2	0	0	2
Puppet Master	0	0	1	0	1	2
Blow-Out (La grande bouffe)	1	1	0	0	0	2
Fighting Seabees, The	0	1	1	0	0	2
Woman of Paris, A	1	1	0	0	0	2
Flying Tigers	0	1	0	1	0	2
Soloist, The	0	2	0	0	0	2
Neon Genesis Evangelion: Death & Rebirth (Shin seiki Evangelion Gekijô-ban: Shito shinsei)	1	1	0	0	0	2
Fullmetal Alchemist the Movie: Conqueror of Shamballa (Gekijô-ban hagane no renkinjutsushi: Shanbara wo yuku mono)	0	1	0	1	0	2
Whipped	0	0	1	0	1	2
Land That Time Forgot, The	0	0	0	1	1	2
Inferno	0	1	0	1	0	2
Human Traffic	0	1	1	0	0	2
Up at the Villa	0	1	1	0	0	2
Two Moon Junction	0	0	1	0	1	2
Limits of Control, The	0	0	2	0	0	2
Carnosaur 2	0	0	0	1	1	2
Home	1	1	0	0	0	2
Time Code	0	1	0	1	0	2
Idiots, The (Idioterne)	1	1	0	0	0	2
Whatever Works	0	0	2	0	0	2
Librarian, The: The Curse of the Judas Chalice	0	2	0	0	0	2
What Ever Happened to Baby Jane?	1	1	0	0	0	2
Filth and the Fury, The	0	1	1	0	0	2
Race to Witch Mountain	0	2	0	0	0	2
Paper Heart	1	0	0	0	1	2
It Might Get Loud	1	0	1	0	0	2
Most Hated Family in America, The	1	1	0	0	0	2
Jennifer's Body	0	0	0	1	1	2
Extract	0	0	1	0	1	2
World's Greatest Dad	1	0	0	1	0	2
I Sell the Dead	0	1	0	1	0	2
Place in the Sun, A	1	1	0	0	0	2
Jonah Who Will Be 25 in the Year 2000 (Jonas qui aura 25 ans en l'an 2000)	2	0	0	0	0	2
Whatever It Takes	0	0	1	1	0	2
Here on Earth	0	1	0	1	0	2
Black Dynamite	1	0	0	1	0	2
Gentlemen Broncos	0	1	0	0	1	2
Good Earth, The	0	2	0	0	0	2
Funny Bones	0	1	0	1	0	2
Christmas Carol, A	0	1	1	0	0	2
Battlestar Galactica: The Plan	1	1	0	0	0	2
Bad Lieutenant: Port of Call New Orleans	0	0	1	1	0	2
Death Wish 3	0	0	0	1	1	2
Seven Sisters	1	1	0	0	0	2
Turtle Diary	0	2	0	0	0	2
Pontypool	0	2	0	0	0	2
Hachiko: A Dog's Story (a.k.a. Hachi: A Dog's Tale)	1	0	0	1	0	2
Who's That Girl?	0	0	1	1	0	2
Project A 2 ('A' gai wak juk jap)	1	0	1	0	0	2
Bridge at Remagen, The	0	2	0	0	0	2
Betrayed	0	0	1	1	0	2
Big Country, The	0	1	1	0	0	2
3 Idiots	2	0	0	0	0	2
Stan Helsing	0	0	0	0	2	2
Before the Rain (Pred dozhdot)	0	2	0	0	0	2
Triangle	1	1	0	0	0	2
I Love You Phillip Morris	0	0	1	0	1	2
Splendor in the Grass	1	1	0	0	0	2
Anne of Green Gables: The Sequel (a.k.a. Anne of Avonlea)	2	0	0	0	0	2
Browning Version, The	0	1	1	0	0	2
Wolfman, The	0	1	0	0	1	2
Class Reunion	0	0	0	1	1	2
Secret of Kells, The	1	1	0	0	0	2
Beautiful People	2	0	0	0	0	2
District 13: Ultimatum (Banlieue 13 - Ultimatum)	0	2	0	0	0	2
Gentlemen of Fortune (Dzhentlmeny udachi)	2	0	0	0	0	2
Minnie and Moskowitz	1	0	0	1	0	2
Town Called Panic, A (Panique au village)	0	2	0	0	0	2
From Paris with Love	0	0	1	1	0	2
Harry Brown	0	2	0	0	0	2
Frozen	0	1	1	0	0	2
Slammin' Salmon, The	1	0	1	0	0	2
Micmacs (Micmacs à tire-larigot)	1	0	1	0	0	2
Death at a Funeral	0	1	1	0	0	2
Cup, The (Phörpa)	1	1	0	0	0	2
Big Tease, The	0	1	1	0	0	2
Nightmare on Elm Street, A	0	0	0	1	1	2
Zed & Two Noughts, A	1	0	0	0	1	2
American Flyers	1	0	0	1	0	2
Cry in the Dark, A	0	2	0	0	0	2
Unzipped	0	1	0	1	0	2
Killers	0	0	1	1	0	2
Sex and the City 2	0	0	0	1	1	2
TiMER	0	2	0	0	0	2
Enter the Void	2	0	0	0	0	2
Serbian Film, A (Srpski film)	0	1	0	0	1	2
Boiling Point	0	1	0	1	0	2
Onegin	0	1	0	1	0	2
I Killed My Mother (J'ai tué ma mère)	0	1	1	0	0	2
War Zone, The	0	1	1	0	0	2
Hush... Hush, Sweet Charlotte	1	1	0	0	0	2
Two Jakes, The	0	0	0	1	1	2
Stealing Home	0	0	2	0	0	2
Distinguished Gentleman, The	0	1	1	0	0	2
Eat Pray Love	0	2	0	0	0	2
Legend of the Guardians: The Owls of Ga'Hoole	0	2	0	0	0	2
Middle Men	0	1	1	0	0	2
Stanley & Iris	0	1	0	1	0	2
Devil	0	1	1	0	0	2
Stone	0	1	1	0	0	2
Maurice	0	2	0	0	0	2
Rubber	0	2	0	0	0	2
Heartbeats (Les amours imaginaires)	0	0	2	0	0	2
Liberty Heights	0	2	0	0	0	2
42 Up	0	2	0	0	0	2
Biutiful	1	1	0	0	0	2
Art of the Steal, The	0	2	0	0	0	2
Loved Ones, The	1	1	0	0	0	2
Casino Jack	1	0	1	0	0	2
Rare Exports: A Christmas Tale (Rare Exports)	1	1	0	0	0	2
Incredibly True Adventure of Two Girls in Love, The	1	1	0	0	0	2
All Good Things	1	0	1	0	0	2
Meatballs III	0	0	1	1	0	2
Taming of the Shrew, The	0	0	1	1	0	2
Marwencol	1	1	0	0	0	2
Dilemma, The	0	0	2	0	0	2
I Spit on Your Grave	0	2	0	0	0	2
All-Star Superman	1	1	0	0	0	2
Train of Life (Train de vie)	2	0	0	0	0	2
Cedar Rapids	0	0	1	1	0	2
Emma	1	0	0	0	1	2
Drive Angry	0	2	0	0	0	2
Crazy in Alabama	0	1	0	1	0	2
Fever Pitch	0	0	2	0	0	2
Red Riding Hood	0	1	1	0	0	2
Troll Hunter, The (Trolljegeren)	0	2	0	0	0	2
Room in Rome (Habitación en Roma)	1	0	0	0	1	2
Hop	0	1	0	1	0	2
Reds	0	1	1	0	0	2
Razor's Edge, The	0	1	1	0	0	2
Brief Encounter	0	1	1	0	0	2
Kill the Irishman	0	2	0	0	0	2
Something Borrowed	0	1	1	0	0	2
Tree of Life, The	1	0	1	0	0	2
The Way	0	2	0	0	0	2
Bernie	0	0	1	0	1	2
Psycho III	0	0	1	1	0	2
Elektra Luxx	0	1	0	1	0	2
Larry Crowne	0	1	0	1	0	2
Monkey Shines	0	0	1	1	0	2
Nadja	0	1	1	0	0	2
Mute Witness	0	1	1	0	0	2
Takers	0	1	0	1	0	2
Adventures of Elmo in Grouchland, The	0	0	0	1	1	2
Hell Night	0	0	0	2	0	2
Woman, The	0	2	0	0	0	2
Fright Night Part II	0	0	1	0	1	2
Our Idiot Brother	0	1	1	0	0	2
Death Race 2	0	1	1	0	0	2
Terri	1	0	0	1	0	2
Very Harold & Kumar 3D Christmas, A	0	1	1	0	0	2
Only Angels Have Wings	0	0	2	0	0	2
Don't Be Afraid of the Dark	0	1	1	0	0	2
Fright Night	0	1	1	0	0	2
Dudley Do-Right	0	0	0	1	1	2
Conan the Barbarian	0	0	1	0	1	2
Mad Love	0	0	0	1	1	2
Cold Fish (Tsumetai nettaigyo)	2	0	0	0	0	2
Dangerous Method, A	0	1	1	0	0	2
Gigi	1	0	1	0	0	2
Take Shelter	1	0	1	0	0	2
Footloose	0	0	2	0	0	2
Final Conflict, The (a.k.a. Omen III: The Final Conflict)	0	0	1	0	1	2
Martha Marcy May Marlene	1	0	1	0	0	2
Masque of the Red Death, The	0	1	1	0	0	2
Paranormal Activity 3	0	2	0	0	0	2
Puncture	0	1	1	0	0	2
Adventures of Sebastian Cole, The	0	1	1	0	0	2
Morning After, The	0	2	0	0	0	2
Like Crazy	0	1	0	0	1	2
No Mercy	0	0	0	2	0	2
Extremely Loud and Incredibly Close	0	1	0	1	0	2
Vibes	0	0	0	2	0	2
Asterix in America (a.k.a Asterix Conquers America) (Astérix et les Indiens)	0	2	0	0	0	2
Violet & Daisy	1	0	0	1	0	2
Snowman, The	0	2	0	0	0	2
Young Adult	0	1	0	0	1	2
Darkest Hour, The	0	0	1	1	0	2
Alvin and the Chipmunks: Chipwrecked	0	0	0	0	2	2
Contraband	0	1	0	1	0	2
Whistleblower, The	0	1	1	0	0	2
One for the Money	0	0	1	0	1	2
Innkeepers, The	0	1	0	1	0	2
Woman in Black, The	0	2	0	0	0	2
Loss of Sexual Innocence, The	0	0	1	1	0	2
Art of Getting By, The	0	1	0	1	0	2
All Watched Over by Machines of Loving Grace	1	1	0	0	0	2
Pork Chop Hill	0	1	1	0	0	2
Monsieur Lazhar	1	1	0	0	0	2
Perfect Sense	1	1	0	0	0	2
Very Potter Musical, A	1	1	0	0	0	2
Mother!	0	1	1	0	0	2
Besieged (a.k.a. L' Assedio)	0	1	1	0	0	2
Love Letter, The	0	0	1	1	0	2
Black Mask (Hak hap)	0	1	0	1	0	2
After Life (Wandafuru raifu)	1	1	0	0	0	2
Chopping Mall (a.k.a. Killbots)	0	0	0	0	2	2
Get Real	1	1	0	0	0	2
Act of Valor	1	0	1	0	0	2
Lost & Found	0	0	2	0	0	2
Damsels in Distress	0	0	1	1	0	2
Goodbye Lover	0	0	1	0	1	2
Lovers of the Arctic Circle, The (Los Amantes del Círculo Polar)	1	1	0	0	0	2
Iron Sky	0	2	0	0	0	2
Three Stooges, The	0	0	0	1	1	2
Bully	0	2	0	0	0	2
Hysteria	0	2	0	0	0	2
Doug's 1st Movie	0	0	1	0	1	2
Think Like a Man	0	0	1	1	0	2
Safe	0	1	1	0	0	2
My Boyfriend's Back	0	0	0	1	1	2
Deep End of the Ocean, The	0	1	1	0	0	2
Bernie	0	1	1	0	0	2
American Made	1	1	0	0	0	2
Dragon Ball: Sleeping Princess in Devil's Castle (Doragon bôru: Majinjô no nemuri hime)	0	1	1	0	0	2
Rollercoaster	0	0	1	1	0	2
Airport 1975	0	1	1	0	0	2
Dragon Ball Z the Movie: The Tree of Might (Doragon bôru Z 3: Chikyû marugoto chô kessen)	0	1	0	1	0	2
Children of the Corn II: The Final Sacrifice	0	0	0	2	0	2
Dragon Ball Z: Cooler's Revenge (Doragon bôru Z 5: Tobikkiri no saikyô tai saikyô)	0	2	0	0	0	2
Dragon Ball Z: Super Android 13! (Doragon bôru Z 7: Kyokugen batoru!! San dai sûpâ saiyajin)	0	2	0	0	0	2
Last Days, The	0	2	0	0	0	2
Savages	0	0	2	0	0	2
Still Crazy	0	0	2	0	0	2
Addiction, The	0	0	0	1	1	2
Paddington 2	1	1	0	0	0	2
Dragon Ball Z: The History of Trunks (Doragon bôru Z: Zetsubô e no hankô!! Nokosareta chô senshi - Gohan to Torankusu)	1	0	0	1	0	2
In Dreams	0	0	0	2	0	2
ParaNorman	0	1	1	0	0	2
General, The	0	2	0	0	0	2
Resident Evil: Retribution	0	2	0	0	0	2
Extremities	0	2	0	0	0	2
V/H/S	0	1	0	1	0	2
Marley	1	0	1	0	0	2
Frankenweenie	0	0	1	1	0	2
Prancer	0	0	2	0	0	2
Catch .44	0	0	0	1	1	2
[REC]³ 3 Génesis	0	0	2	0	0	2
Imposter, The	2	0	0	0	0	2
Jackass 3.5	1	0	1	0	0	2
Indie Game: The Movie	0	0	2	0	0	2
Red Dawn	0	0	1	1	0	2
Fantastic Fear of Everything, A	1	0	1	0	0	2
Fearless Hyena, The (Xiao quan guai zhao)	0	0	2	0	0	2
King Kong vs. Godzilla (Kingukongu tai Gojira)	0	0	1	1	0	2
Godzilla 1985: The Legend Is Reborn (Gojira) (Godzilla) (Return of Godzilla, The)	0	0	0	1	1	2
Winners and Sinners (Qi mou miao ji: Wu fu xing)	0	0	2	0	0	2
Heart Condition	0	1	1	0	0	2
John Dies at the End	1	1	0	0	0	2
Hard Core Logo	1	0	1	0	0	2
Misérables, Les	0	0	1	1	0	2
It's Such a Beautiful Day	1	1	0	0	0	2
Belly	0	0	0	1	1	2
Christina P: Mother Inferior	0	1	1	0	0	2
Hands on a Hard Body	1	1	0	0	0	2
Last Stand, The	0	1	1	0	0	2
Cruise, The	1	1	0	0	0	2
Beloved	1	1	0	0	0	2
Frozen Planet	2	0	0	0	0	2
Impostors, The	1	1	0	0	0	2
Escape from Planet Earth	1	1	0	0	0	2
Dark Skies	0	1	0	1	0	2
Journey to the West: Conquering the Demons (Daai wa sai you chi Chui mo chun kei)	2	0	0	0	0	2
Sheltering Sky, The	0	1	1	0	0	2
Clay Pigeons	0	0	2	0	0	2
Stoker	0	2	0	0	0	2
One True Thing	0	0	2	0	0	2
Permanent Midnight	0	0	2	0	0	2
First Time, The	0	0	0	2	0	2
Mortal Thoughts	0	0	1	1	0	2
Evil Dead	0	1	1	0	0	2
Trance	0	2	0	0	0	2
Perfect Plan, A (Plan parfait, Un)	1	1	0	0	0	2
Wisdom	0	0	1	1	0	2
Parasite	0	0	1	1	0	2
Young Doctors in Love	0	0	0	1	1	2
Allnighter, The	0	0	0	1	1	2
Sabotage	0	1	1	0	0	2
Syrup	0	1	0	1	0	2
Only God Forgives	0	2	0	0	0	2
Epic	0	1	1	0	0	2
Paradine Case, The	0	1	1	0	0	2
Stage Fright	0	2	0	0	0	2
I Confess	0	2	0	0	0	2
Frenzy	0	1	1	0	0	2
After Earth	0	0	0	1	1	2
Kings of Summer, The	0	1	1	0	0	2
20 Feet from Stardom (Twenty Feet from Stardom)	1	1	0	0	0	2
Your Friends and Neighbors	0	1	1	0	0	2
Bling Ring, The	0	0	1	1	0	2
How Stella Got Her Groove Back	0	0	0	2	0	2
The Spectacular Now	0	1	1	0	0	2
Lifeguard, The	1	0	0	1	0	2
Fruitvale Station	0	2	0	0	0	2
Coffee Town	0	0	1	1	0	2
Percy Jackson: Sea of Monsters	0	0	1	0	1	2
Man of Tai Chi	1	0	0	1	0	2
Planes	0	1	1	0	0	2
Blackfish	0	1	0	1	0	2
In a World...	1	1	0	0	0	2
Justice League: Crisis on Two Earths	0	1	1	0	0	2
You're Next	1	0	1	0	0	2
Boys of St. Vincent, The	0	2	0	0	0	2
History of Future Folk, The	1	1	0	0	0	2
Insidious: Chapter 2	0	0	2	0	0	2
Short Term 12	0	2	0	0	0	2
Enough Said	0	1	1	0	0	2
Century of the Self, The	0	2	0	0	0	2
Crystal Fairy & the Magical Cactus and 2012	0	1	1	0	0	2
Steal Big, Steal Little	0	0	2	0	0	2
Runner Runner	0	0	1	1	0	2
If Lucy Fell	0	0	1	1	0	2
Blue Is the Warmest Color (La vie d'Adèle)	0	1	1	0	0	2
Cloudy with a Chance of Meatballs 2	0	0	1	1	0	2
Son of Flubber	0	0	1	1	0	2
Machete Kills (Machete 2)	1	0	1	0	0	2
Filth	1	1	0	0	0	2
Carrie	0	0	1	1	0	2
Jackass Presents: Bad Grandpa	0	1	1	0	0	2
Last Vegas	0	0	0	2	0	2
Philomena	1	0	0	1	0	2
Mandela: Long Walk to Freedom	0	2	0	0	0	2
And the Band Played On	0	1	1	0	0	2
Trip to Bountiful, The	1	1	0	0	0	2
Fanny and Alexander (Fanny och Alexander)	1	0	0	0	1	2
Lone Survivor	0	1	1	0	0	2
Oldboy	0	1	1	0	0	2
Fuck You, Goethe (Fack Ju Göhte)	0	1	0	1	0	2
Devil and Max Devlin, The	0	0	1	1	0	2
Grudge Match	0	1	0	1	0	2
Dragon Ball Z: Battle of Gods	0	2	0	0	0	2
We Are What We Are	0	0	1	1	0	2
Jack Ryan: Shadow Recruit	0	0	1	1	0	2
I, Frankenstein	0	1	0	0	1	2
Nymphomaniac: Volume I	1	1	0	0	0	2
Knights of Badassdom	0	0	1	1	0	2
Polish Wedding	1	0	0	1	0	2
About Last Night	0	0	1	1	0	2
3 Days to Kill	0	0	0	1	1	2
Welcome to the Jungle	0	0	1	1	0	2
Prom Night	0	0	1	1	0	2
Halloween 5: The Revenge of Michael Myers	0	0	0	1	1	2
Under the Skin	0	1	0	1	0	2
Need for Speed	0	2	0	0	0	2
Barefoot	0	1	0	1	0	2
Friday the 13th Part V: A New Beginning	0	0	1	1	0	2
Veronica Mars	0	0	0	2	0	2
Why Don't You Play In Hell? (Jigoku de naze warui)	1	1	0	0	0	2
Rio 2	0	0	1	1	0	2
Honest Liar, An	0	2	0	0	0	2
Chef	0	0	2	0	0	2
Zombeavers	0	1	0	1	0	2
Hamlet	0	1	1	0	0	2
The Disaster Artist	1	0	1	0	0	2
Going My Way	0	1	1	0	0	2
The Post	1	1	0	0	0	2
Grand Hotel	0	2	0	0	0	2
Whatever	0	1	1	0	0	2
Planes: Fire & Rescue	0	0	1	1	0	2
Tammy	0	0	1	0	1	2
Heidi Fleiss: Hollywood Madam	2	0	0	0	0	2
I Went Down	0	0	0	2	0	2
Mr. Jealousy	0	0	1	1	0	2
High Art	0	1	1	0	0	2
Almost Heroes	0	0	1	1	0	2
Housebound	1	1	0	0	0	2
Quest for Camelot	0	0	1	0	1	2
Jupiter Ascending	0	0	1	1	0	2
Jack Whitehall: At Large	0	2	0	0	0	2
Inbetweeners 2, The	0	2	0	0	0	2
Coherence	0	2	0	0	0	2
Pride	0	2	0	0	0	2
Chinese Box	0	1	1	0	0	2
Hush	0	0	1	0	1	2
Welcome to Woop-Woop	0	2	0	0	0	2
This Is Where I Leave You	0	1	0	1	0	2
Angel's Egg (Tenshi no tamago)	0	1	1	0	0	2
Hector and the Search for Happiness	1	1	0	0	0	2
B. Monkey	0	0	1	1	0	2
Annabelle	0	1	1	0	0	2
Music From Another Room	0	1	0	1	0	2
St. Vincent	0	1	1	0	0	2
The Book of Life	1	1	0	0	0	2
Stranger in the House	1	0	0	1	0	2
Dead Snow 2: Red vs. Dead	1	1	0	0	0	2
Butcher Boy, The	1	0	1	0	0	2
Bent	1	0	0	1	0	2
Artemisia	0	2	0	0	0	2
Exodus: Gods and Kings	0	1	0	1	0	2
Too Many Cooks	1	0	0	1	0	2
Asterix: The Land of the Gods (Astérix: Le domaine des dieux)	0	2	0	0	0	2
Gang Related	0	0	2	0	0	2
Washington Square	0	2	0	0	0	2
Indian Summer (a.k.a. Alive & Kicking)	0	0	0	2	0	2
White Balloon, The (Badkonake sefid)	0	2	0	0	0	2
Thousand Acres, A	0	0	1	0	1	2
Wishmaster	0	0	1	1	0	2
Soul Food	1	0	0	1	0	2
The Mule	0	1	1	0	0	2
Selma	0	0	1	1	0	2
Kiss Me, Guido	0	0	2	0	0	2
Girl Walks Home Alone at Night, A	0	1	1	0	0	2
Dave Chappelle: For What it's Worth	1	1	0	0	0	2
She's So Lovely	0	1	1	0	0	2
Top Five	0	0	2	0	0	2
Big Eyes	0	2	0	0	0	2
Seventh Son	0	1	0	0	1	2
Simple Wish, A	0	0	2	0	0	2
Blackhat	0	0	1	1	0	2
Contempt (Mépris, Le)	0	1	1	0	0	2
When the Cat's Away (Chacun cherche son chat)	1	1	0	0	0	2
For Roseanna (Roseanna's Grave)	1	0	1	0	0	2
Shiloh	0	1	1	0	0	2
Ponette	1	1	0	0	0	2
To Grandmother's House We Go	1	0	0	0	1	2
Promise, The (La promesse)	1	1	0	0	0	2
Kissed	0	0	1	1	0	2
Turbo: A Power Rangers Movie	0	0	0	2	0	2
B*A*P*S	0	0	0	1	1	2
Cats Don't Dance	0	1	0	1	0	2
Insidious: Chapter 3	0	0	1	1	0	2
That Darn Cat	0	1	1	0	0	2
Cake	0	0	2	0	0	2
Amos & Andrew	0	0	0	1	1	2
Cement Garden, The	1	1	0	0	0	2
When We First Met	0	2	0	0	0	2
Halloweentown High	0	2	0	0	0	2
Angel Baby	0	0	2	0	0	2
Walkabout	1	1	0	0	0	2
Portrait of a Lady, The	0	1	1	0	0	2
Thieves (Voleurs, Les)	0	1	0	0	1	2
Whole Wide World, The	1	1	0	0	0	2
The Pacific	2	0	0	0	0	2
La Cérémonie	1	1	0	0	0	2
Bastard Out of Carolina	0	2	0	0	0	2
True Story	0	1	1	0	0	2
Going Clear: Scientology and the Prison of Belief	1	1	0	0	0	2
The Overnight	1	0	1	0	0	2
A Pigeon Sat on a Branch Reflecting on Existence	1	1	0	0	0	2
Paper Towns	0	1	0	0	1	2
Chris Rock: Bigger & Blacker	1	0	1	0	0	2
Albino Alligator	0	0	1	1	0	2
The Cloverfield Paradox	0	1	0	0	1	2
Stitch! The Movie	1	0	1	0	0	2
Burnt Offerings	1	0	1	0	0	2
Blood for Dracula (Andy Warhol's Dracula)	0	1	0	1	0	2
Amityville Curse, The	0	0	0	0	2	2
Marvel One-Shot: Item 47	0	1	0	1	0	2
The Second Best Exotic Marigold Hotel	0	1	1	0	0	2
Amityville: A New Generation	0	0	0	1	1	2
Lamerica	2	0	0	0	0	2
Female Perversions	0	0	1	1	0	2
Unfinished Business	0	0	1	1	0	2
The Cobbler	1	0	1	0	0	2
Shaun the Sheep Movie	0	1	1	0	0	2
Iliza Shlesinger: Freezing Hot	0	2	0	0	0	2
Da Sweet Blood of Jesus	1	0	0	1	0	2
The Longest Ride	0	0	1	0	1	2
Man Up	0	2	0	0	0	2
Welcome to Me	1	0	0	1	0	2
Office Romance	1	0	1	0	0	2
Slow West	1	1	0	0	0	2
Ghost in the Shell: Stand Alone Complex - The Laughing Man	0	1	1	0	0	2
Self/less	0	1	0	1	0	2
Sharknado 3: Oh Hell No!	0	0	0	0	2	2
Ghost in the Shell 2.0	0	2	0	0	0	2
Creep	0	1	0	1	0	2
Best of the Best 3: No Turning Back	0	0	1	1	0	2
Dear God	0	1	1	0	0	2
Lesson Faust	2	0	0	0	0	2
Fred Armisen: Standup for Drummers	0	1	1	0	0	2
Search Party	0	1	0	0	1	2
Perfect Candidate, A	1	1	0	0	0	2
Palookaville	1	1	0	0	0	2
Loser	0	1	0	0	1	2
7 Days in Hell	0	2	0	0	0	2
The Walk	0	1	1	0	0	2
Old Man and the Sea, The	0	1	1	0	0	2
10 Cent Pistol	0	0	0	1	1	2
Anomalisa	0	1	1	0	0	2
How to Make Love Like an Englishman	0	0	1	1	0	2
Shadow Conspiracy	0	0	0	1	1	2
Cop Car	0	1	1	0	0	2
Victor Frankenstein	1	0	0	1	0	2
Scouts Guide to the Zombie Apocalypse	0	2	0	0	0	2
Legend	0	1	1	0	0	2
The Danish Girl	0	2	0	0	0	2
Unbelievable Adventures of Italians in Russia	1	0	0	1	0	2
Beasts of No Nation	0	0	2	0	0	2
The Blue Planet	2	0	0	0	0	2
Grace of My Heart	0	0	2	0	0	2
Pompatus of Love, The	1	0	0	1	0	2
Dangerous Ground	0	0	2	0	0	2
Our Brand Is Crisis	0	1	0	1	0	2
High Rise	0	1	1	0	0	2
The Brand New Testament	1	1	0	0	0	2
Hardcore Henry	1	0	1	0	0	2
Sherlock - A Study in Pink	2	0	0	0	0	2
The Little Prince	0	0	1	1	0	2
Mark of Zorro, The	0	2	0	0	0	2
Ashby	0	1	1	0	0	2
Love in the Afternoon	0	1	1	0	0	2
Cry, the Beloved Country	1	1	0	0	0	2
Silence	1	0	1	0	0	2
Little Princess, The	0	1	1	0	0	2
Goosebumps	0	0	1	1	0	2
Bone Tomahawk	2	0	0	0	0	2
Gay Divorcee, The	0	1	1	0	0	2
For Whom the Bell Tolls	0	2	0	0	0	2
Wild Reeds (Les roseaux sauvages)	0	0	1	1	0	2
Pacific Rim: Uprising	0	0	2	0	0	2
Bogus	0	0	1	1	0	2
Gone Fishin'	0	0	0	0	2	2
Carpool	0	0	1	0	1	2
Eyes Without a Face (Yeux sans visage, Les)	0	0	2	0	0	2
Jurassic World: Fallen Kingdom	0	1	1	0	0	2
Doctor Who: Last Christmas	1	0	1	0	0	2
Doctor Who: A Christmas Carol	2	0	0	0	0	2
The 5th Wave	0	1	0	1	0	2
Alaska	0	1	1	0	0	2
Chi-Raq	1	0	1	0	0	2
The Ridiculous 6	0	1	1	0	0	2
Saw	1	1	0	0	0	2
Somebody to Love	0	1	1	0	0	2
World of Tomorrow	1	1	0	0	0	2
'Til There Was You	1	0	1	0	0	2
Heavy	0	1	1	0	0	2
Stalingrad	1	1	0	0	0	2
Maya Lin: A Strong Clear Vision	0	1	1	0	0	2
Close Range	0	0	2	0	0	2
Doctor Who: The Husbands of River Song	1	1	0	0	0	2
Boys	0	0	0	2	0	2
Death Note Rewrite: Genshisuru Kami	0	2	0	0	0	2
True Crime	0	2	0	0	0	2
It's My Party	1	0	1	0	0	2
Grease Live	0	0	1	0	1	2
London Has Fallen	0	1	0	0	1	2
World of Apu, The (Apur Sansar)	2	0	0	0	0	2
Song of the Little Road (Pather Panchali)	1	1	0	0	0	2
Nelly & Monsieur Arnaud	0	1	1	0	0	2
Family Thing, A	0	0	2	0	0	2
The Neon Demon	0	1	1	0	0	2
Get a Job	0	1	1	0	0	2
Keanu	0	1	0	1	0	2
Money Monster	0	0	1	1	0	2
Bhaji on the Beach	0	1	1	0	0	2
Chasers	0	0	0	1	1	2
Thirty-Two Short Films About Glenn Gould	1	1	0	0	0	2
Surviving the Game	0	1	1	0	0	2
Kill Command	0	0	1	1	0	2
Swiss Army Man	0	1	1	0	0	2
The Do-Over	1	0	1	0	0	2
Fear X	0	0	1	1	0	2
Christmas Carol, A (Scrooge)	0	1	1	0	0	2
The Fundamentals of Caring	0	2	0	0	0	2
Please Don't Eat the Daisies	0	1	1	0	0	2
Picture of Dorian Gray, The	0	1	0	0	1	2
Jetée, La	1	1	0	0	0	2
Blackboard Jungle	0	1	1	0	0	2
Hour of the Wolf (Vargtimmen)	2	0	0	0	0	2
Dr. Jekyll and Mr. Hyde	0	1	0	0	1	2
Dear Frankie	0	2	0	0	0	2
Popstar: Never Stop Never Stopping	0	1	0	1	0	2
Claymation Christmas Celebration, A	0	0	1	0	1	2
Soul Plane	1	0	1	0	0	2
Undead	0	1	1	0	0	2
Caine Mutiny, The	0	2	0	0	0	2
Dolls	1	1	0	0	0	2
Mitchell	0	0	0	0	2	2
Hairdresser's Husband, The (Le mari de la coiffeuse)	0	2	0	0	0	2
Point of No Return	1	1	0	0	0	2
Manufacturing Consent: Noam Chomsky and the Media	1	1	0	0	0	2
Mission: Impossible - Fallout	0	2	0	0	0	2
Safety Last!	1	0	1	0	0	2
Ugetsu (Ugetsu monogatari)	0	1	0	0	1	2
Avventura, L' (Adventure, The)	0	2	0	0	0	2
Revenge of the Pink Panther	0	1	1	0	0	2
Captain Blood	0	2	0	0	0	2
Angels with Dirty Faces	0	2	0	0	0	2
Dead or Alive: Hanzaisha	1	1	0	0	0	2
Attack of the Giant Leeches	0	1	0	0	1	2
Taxi 3	1	0	0	1	0	2
Our Hospitality	0	1	1	0	0	2
Seducing Doctor Lewis (Grande séduction, La)	0	0	1	0	1	2
The Conjuring 2	0	1	0	0	1	2
All of Me	0	1	0	1	0	2
Stendhal Syndrome, The (Sindrome di Stendhal, La)	0	1	0	0	1	2
Thing Called Love, The	0	1	1	0	0	2
Getaway, The	1	1	0	0	0	2
Exterminating Angel, The (Ángel exterminador, El)	0	0	1	0	1	2
Silence, The (Tystnaden)	0	1	1	0	0	2
Short Film About Killing, A (Krótki film o zabijaniu)	1	0	1	0	0	2
People Under the Stairs, The	0	2	0	0	0	2
Hidden Fortress, The (Kakushi-toride no san-akunin)	1	1	0	0	0	2
Bring Me the Head of Alfredo Garcia	0	2	0	0	0	2
Pat Garrett and Billy the Kid	0	2	0	0	0	2
How to Succeed in Business Without Really Trying	1	1	0	0	0	2
Highway 61	0	1	1	0	0	2
I Walked with a Zombie	0	1	0	0	1	2
Legend, The (Legend of Fong Sai-Yuk, The) (Fong Sai Yuk)	0	1	1	0	0	2
Flash Gordon Conquers the Universe	0	0	0	1	1	2
Children of Dune	1	0	1	0	0	2
Program, The	0	1	0	1	0	2
Virgin Spring, The (Jungfrukällan)	0	2	0	0	0	2
The Purge: Election Year	1	0	0	0	1	2
11'09"01 - September 11	0	2	0	0	0	2
Sniper	1	0	0	1	0	2
Bang, Bang, You're Dead	0	2	0	0	0	2
Best of Youth, The (La meglio gioventù)	2	0	0	0	0	2
Alexander Nevsky (Aleksandr Nevskiy)	1	0	1	0	0	2
Tuesdays with Morrie	0	2	0	0	0	2
Explorers	1	0	1	0	0	2
Pat and Mike	0	2	0	0	0	2
Snake Pit, The	0	1	1	0	0	2
Leopard, The (Gattopardo, Il)	1	1	0	0	0	2
Versus	0	2	0	0	0	2
Orlando	1	1	0	0	0	2
To End All Wars	1	1	0	0	0	2
Noises Off...	0	2	0	0	0	2
Rose Red	0	1	0	1	0	2
Lights Out	0	0	2	0	0	2
Chaplin	0	2	0	0	0	2
Oklahoma!	1	1	0	0	0	2
Biggles	0	1	1	0	0	2
Woman of the Year	0	2	0	0	0	2
Fountainhead, The	0	1	1	0	0	2
No Escape	0	0	2	0	0	2
Yesterday, Today and Tomorrow (Ieri, oggi, domani)	1	1	0	0	0	2
Kwaidan (Kaidan)	1	0	0	0	1	2
Three Faces of Eve, The	0	2	0	0	0	2
Happy Together (a.k.a. Buenos Aires Affair) (Chun gwong cha sit)	2	0	0	0	0	2
Sherlock Holmes: Dressed to Kill	0	2	0	0	0	2
Thunderbirds	0	0	2	0	0	2
Godsend	0	0	2	0	0	2
Danny Deckchair	0	1	1	0	0	2
Paper Clips	0	1	1	0	0	2
We Don't Live Here Anymore	1	1	0	0	0	2
Anacondas: The Hunt for the Blood Orchid	0	0	0	2	0	2
Warriors of Heaven and Earth (Tian di ying xiong)	0	1	1	0	0	2
Cheaper by the Dozen	0	1	0	1	0	2
I'm Not Scared (Io non ho paura)	1	1	0	0	0	2
Vitelloni, I (a.k.a. The Young and the Passionate)	0	1	1	0	0	2
Taxi	0	0	0	2	0	2
P.S.	1	1	0	0	0	2
Wilbur Wants to Kill Himself	0	2	0	0	0	2
Being Julia	0	0	1	0	1	2
Surviving Christmas	0	0	2	0	0	2
Corbeau, Le (Raven, The)	1	1	0	0	0	2
Twisted	0	1	0	1	0	2
SpongeBob SquarePants Movie, The	0	1	0	1	0	2
Christmas with the Kranks	0	0	2	0	0	2
Against the Ropes	0	0	0	2	0	2
Mr. Wonderful	0	0	1	1	0	2
Flesh & Blood	0	1	1	0	0	2
Black Widow	0	0	2	0	0	2
Fire in the Sky	0	0	0	2	0	2
Sherlock Jr.	0	1	0	1	0	2
Piper	2	0	0	0	0	2
Scarface	0	2	0	0	0	2
Reefer Madness (a.k.a. Tell Your Children)	0	1	1	0	0	2
Mr. Deeds Goes to Town	0	2	0	0	0	2
I Was a Male War Bride	1	1	0	0	0	2
Dr. Jekyll and Mr. Hyde	0	2	0	0	0	2
Adventures of Ford Fairlane, The	0	1	0	1	0	2
Only the Strong	0	0	2	0	0	2
Torque	0	0	1	1	0	2
Aileen: Life and Death of a Serial Killer	0	1	1	0	0	2
Wuthering Heights	0	1	1	0	0	2
Random Harvest	1	1	0	0	0	2
Day of Wrath (Vredens dag)	0	2	0	0	0	2
Wings of Honneamise (Ôritsu uchûgun Oneamisu no tsubasa)	0	2	0	0	0	2
Crime Story (Zhong an zu)	0	1	1	0	0	2
Foul Play	0	1	0	1	0	2
Pickpocket	0	1	0	1	0	2
Front Page, The	0	2	0	0	0	2
Anna Karenina	0	2	0	0	0	2
Horse Feathers	1	1	0	0	0	2
Amarcord	0	2	0	0	0	2
Passage to India, A	0	2	0	0	0	2
Send Me No Flowers	0	1	1	0	0	2
That Touch of Mink	0	2	0	0	0	2
Hunchback of Notre Dame, The	1	0	1	0	0	2
Cage aux Folles, La	0	0	1	0	0	1
Hatari!	0	0	1	0	0	1
Survivor	0	0	0	0	1	1
Hot Girls Wanted	0	0	1	0	0	1
That Munchhausen	1	0	0	0	0	1
The Taming of the Scoundrel	1	0	0	0	0	1
Mom and Dad Save the World	0	0	0	1	0	1
Who'll Stop the Rain	0	1	0	0	0	1
Phir Hera Pheri	1	0	0	0	0	1
Cat o' Nine Tails, The (Gatto a nove code, Il)	0	1	0	0	0	1
The Quiet Family	0	0	1	0	0	1
Billy Liar	0	1	0	0	0	1
Fuck	0	0	1	0	0	1
BMX Bandits	0	0	1	0	0	1
Shooting Dogs (a.k.a. Beyond the Gates)	0	1	0	0	0	1
Harsh Times	0	0	1	0	0	1
Turtle Power: The Definitive History of the Teenage Mutant Ninja Turtles	0	0	1	0	0	1
Aloha	0	0	0	0	1	1
Fur: An Imaginary Portrait of Diane Arbus	0	0	1	0	0	1
Three Fugitives	0	0	0	0	1	1
A Plasticine Crow	1	0	0	0	0	1
Dragon Blade	0	0	0	1	0	1
Sweetie	0	1	0	0	0	1
Stepfather, The	0	0	1	0	0	1
Skin Deep	0	0	1	0	0	1
There Once Was a Dog	1	0	0	0	0	1
Snatched	0	1	0	0	0	1
Entourage	0	0	0	1	0	1
Scenes from the Class Struggle in Beverly Hills	0	1	0	0	0	1
Santa Sangre	0	1	0	0	0	1
Dam Busters, The	0	1	0	0	0	1
Return of the Musketeers, The	0	0	1	0	0	1
Another Gay Movie	0	1	0	0	0	1
Greenfingers	0	0	0	1	0	1
Cure	1	0	0	0	0	1
The Mummy	0	1	0	0	0	1
Bitter Lake	1	0	0	0	0	1
When the Levees Broke: A Requiem in Four Acts	0	1	0	0	0	1
No Way Jose	0	0	0	1	0	1
Ghost Graduation	1	0	0	0	0	1
Good German, The	0	0	1	0	0	1
Black Christmas	0	0	0	1	0	1
Jeff Ross Roasts the Border	0	1	0	0	0	1
Pink Cadillac	0	0	0	0	1	1
Duck Amuck	0	1	0	0	0	1
The Wolfpack	0	1	0	0	0	1
No Holds Barred	0	0	0	0	1	1
Trevor Noah: African American	0	0	1	0	0	1
The Hairdresser	0	1	0	0	0	1
The Star Wars Holiday Special	0	0	0	0	1	1
Life-Size	0	1	0	0	0	1
Relative Fear	0	0	1	0	0	1
Mr. Holmes	0	0	1	0	0	1
Japanese Story	0	0	1	0	0	1
Company, The	0	0	1	0	0	1
Krampus	0	1	0	0	0	1
Golmaal	1	0	0	0	0	1
The Return of Don Camillo	0	0	1	0	0	1
Last Exit to Brooklyn	0	1	0	0	0	1
Kickboxer	0	0	1	0	0	1
K-9	0	0	0	1	0	1
Jesus of Montreal (Jésus de Montréal)	1	0	0	0	0	1
Johnny Handsome	0	1	0	0	0	1
January Man, The	0	0	0	1	0	1
Bruce Lee: A Warrior's Journey	0	1	0	0	0	1
The Little World of Don Camillo	0	0	1	0	0	1
Her Alibi	0	0	1	0	0	1
Rent-a-Kid	0	0	1	0	0	1
Five Element Ninjas	0	1	0	0	0	1
The Magnificent Ruffians	0	1	0	0	0	1
Gleaming the Cube	0	0	0	1	0	1
Fat Man and Little Boy	0	1	0	0	0	1
Farewell to the King	0	0	1	0	0	1
Absolutely Anything	0	0	1	0	0	1
Primeval	0	0	0	1	0	1
The Silence of the Hams	0	0	1	0	0	1
Bloodsport III	0	0	0	1	0	1
After the Wedding (Efter brylluppet)	0	1	0	0	0	1
Dream a Little Dream	0	0	0	1	0	1
Disorganized Crime	0	1	0	0	0	1
Dad	0	1	0	0	0	1
The Professional: Golgo 13	0	0	1	0	0	1
Mortal Kombat: The Journey Begins	0	0	0	0	1	1
Sandy Wexler	0	0	0	1	0	1
Pygmalion	0	1	0	0	0	1
Blaze	0	0	0	1	0	1
Betting on Zero	0	1	0	0	0	1
Beer League	0	1	0	0	0	1
Best of the Best	0	0	1	0	0	1
Scooby-Doo! and the Samurai Sword	1	0	0	0	0	1
Dead Meat	1	0	0	0	0	1
Win It All	0	0	1	0	0	1
Without a Clue	0	1	0	0	0	1
Scooby-Doo! and the Loch Ness Monster	1	0	0	0	0	1
Tucker: The Man and His Dream	0	0	1	0	0	1
Big Top Scooby-Doo!	1	0	0	0	0	1
Captain Underpants: The First Epic Movie	0	1	0	0	0	1
Scooby-Doo Goes Hollywood	1	0	0	0	0	1
Gabriel Iglesias: Hot and Fluffy	0	0	0	1	0	1
Norbit	0	0	0	0	1	1
George Carlin: Back in Town	1	0	0	0	0	1
John From	0	0	0	0	1	1
George Carlin: You Are All Diseased	1	0	0	0	0	1
Letter, The	0	1	0	0	0	1
Larry David: Curb Your Enthusiasm	1	0	0	0	0	1
It Comes at Night	0	1	0	0	0	1
Kevin Hart: Laugh at My Pain	0	1	0	0	0	1
Hear My Song	0	0	1	0	0	1
Wake Up, Ron Burgundy	0	1	0	0	0	1
Moon Over Parador	0	0	1	0	0	1
Tom and Jerry: Shiver Me Whiskers	1	0	0	0	0	1
Masquerade	0	0	0	0	1	1
Little Nikita	0	0	1	0	0	1
Cars 3	0	0	1	0	0	1
Jeff Dunham: All Over the Map	0	0	0	1	0	1
Ugly Duckling and Me!, The	1	0	0	0	0	1
The FP	1	0	0	0	0	1
When Night Is Falling	0	0	1	0	0	1
High Spirits	0	0	0	1	0	1
Tyler Perry's Daddy's Little Girls	0	0	0	1	0	1
Kung Fu Panda: Secrets of the Masters	1	0	0	0	0	1
Picture Bride (Bijo photo)	0	1	0	0	0	1
For Keeps	0	0	1	0	0	1
Feds	0	0	0	1	0	1
My Father and My Son (Babam ve oglum)	1	0	0	0	0	1
Drowning by Numbers	0	1	0	0	0	1
Factory Girl	0	1	0	0	0	1
Golden Door (Nuovomondo)	1	0	0	0	0	1
Dead Heat	0	0	1	0	0	1
D.O.A.	0	1	0	0	0	1
Crossing Delancey	1	0	0	0	0	1
Mini's First Time	0	1	0	0	0	1
Couch Trip, The	0	0	0	1	0	1
Citizen X	0	1	0	0	0	1
The Hero	0	1	0	0	0	1
Amazing Grace	0	0	1	0	0	1
Macbeth	0	0	1	0	0	1
Pushing Hands (Tui shou)	0	0	0	1	0	1
Nobody Speak: Hulk Hogan, Gawker and Trials of a Free Press	0	1	0	0	0	1
Pyromaniac's Love Story, A	0	0	1	0	0	1
Here Comes Mr. Jordan	0	1	0	0	0	1
The Face of an Angel	0	0	0	1	0	1
Wit	1	0	0	0	0	1
Beast of War, The (Beast, The)	0	1	0	0	0	1
Pusher III: I'm the Angel of Death	0	0	1	0	0	1
Bat*21	0	0	1	0	0	1
Unprecedented: The 2000 Presidential Election	0	1	0	0	0	1
Mina Tannenbaum	0	0	0	0	1	1
Babylon 5: The Gathering	0	1	0	0	0	1
Ruling Class, The	0	0	1	0	0	1
Meshes of the Afternoon	0	0	1	0	0	1
Abandoned, The	0	0	0	1	0	1
1969	0	0	0	1	0	1
First Reformed	0	1	0	0	0	1
Alaska: Spirit of the Wild	0	1	0	0	0	1
Africa: The Serengeti	0	1	0	0	0	1
More	1	0	0	0	0	1
Michael Jordan to the Max	0	1	0	0	0	1
Starter for 10	0	1	0	0	0	1
Jump Tomorrow	0	1	0	0	0	1
Children Are Watching Us, The (Bambini ci guardano, I)	0	1	0	0	0	1
Adanggaman	0	0	0	1	0	1
Prime of Miss Jean Brodie, The	0	1	0	0	0	1
I Think I Love My Wife	0	0	1	0	0	1
Pete's Dragon	0	0	1	0	0	1
T-Rex: Back to the Cretaceous	0	1	0	0	0	1
	0	0	0	0	1	1
Wild Horses	0	0	0	0	1	1
Liquid Truth	0	0	0	1	0	1
Robin Williams: Live on Broadway	0	0	1	0	0	1
Jim Jefferies: Freedumb	1	0	0	0	0	1
Pride	0	0	1	0	0	1
The Death of Louis XIV	0	1	0	0	0	1
Line King: The Al Hirschfeld Story, The	0	1	0	0	0	1
Obsession	0	0	1	0	0	1
10th Victim, The (La decima vittima)	0	1	0	0	0	1
Entertaining Angels: The Dorothy Day Story	1	0	0	0	0	1
Black Book (Zwartboek)	0	0	1	0	0	1
Hustler White	0	1	0	0	0	1
The Squeeze	0	0	0	1	0	1
Are We Done Yet?	0	0	0	1	0	1
Careful What You Wish For	0	0	0	1	0	1
	1	0	0	0	0	1
Robot Overlords	0	0	0	1	0	1
Barefoot Contessa, The	0	0	1	0	0	1
American Hardcore	0	1	0	0	0	1
Bad Asses on the Bayou	0	0	1	0	0	1
Something Wild	0	1	0	0	0	1
Nina Takes a Lover	0	0	1	0	0	1
September	0	1	0	0	0	1
Salvador	1	0	0	0	0	1
The Eye: Infinity	1	0	0	0	0	1
Faust	0	1	0	0	0	1
Kiss me Kismet	0	0	1	0	0	1
Dr. Goldfoot and the Bikini Machine	1	0	0	0	0	1
Da geht noch was!	0	1	0	0	0	1
Villain	1	0	0	0	0	1
Aqua Teen Hunger Force Colon Movie Film for Theaters	0	0	1	0	0	1
Big Deal on Madonna Street (I Soliti Ignoti)	0	1	0	0	0	1
Beach Blanket Bingo	0	0	0	1	0	1
Another Woman	1	0	0	0	0	1
Beyond Bedlam	0	1	0	0	0	1
The Lovers	0	0	0	1	0	1
God Loves Caviar	0	0	0	1	0	1
Mortuary	0	0	0	1	0	1
Dobermann	0	0	1	0	0	1
Kickin It Old Skool	0	0	0	1	0	1
Lumumba	0	0	1	0	0	1
Lucky You	0	0	1	0	0	1
Glory Daze	0	1	0	0	0	1
Sharkwater	0	1	0	0	0	1
Maniac Cop	0	1	0	0	0	1
Let It Snow	1	0	0	0	0	1
New York Cop (Nyû Yôku no koppu)	1	0	0	0	0	1
Ex, The	0	1	0	0	0	1
Baby Boy	0	0	0	0	1	1
April Morning	0	0	1	0	0	1
Drunks	0	0	1	0	0	1
Eighth Day, The (Huitième jour, Le)	0	1	0	0	0	1
Single Girl, A (Fille seule, La)	0	1	0	0	0	1
Fay Grim	0	0	0	1	0	1
Funeral, The	0	0	1	0	0	1
Breed, The	1	0	0	0	0	1
How to Marry a Millionaire	1	0	0	0	0	1
Them (Ils)	0	0	0	1	0	1
Paperhouse	0	1	0	0	0	1
Unlawful Entry	0	0	1	0	0	1
Uncommon Valor	0	0	1	0	0	1
Sun Alley (Sonnenallee)	1	0	0	0	0	1
That Demon Within	0	0	0	1	0	1
Paranoid Park	0	1	0	0	0	1
Bunny	0	0	0	0	1	1
Munna bhai M.B.B.S.	0	0	1	0	0	1
Legend of Sleepy Hollow, The	0	0	0	1	0	1
Starcrash (a.k.a. Star Crash)	0	0	0	0	1	1
Big Eden	1	0	0	0	0	1
Fail-Safe	0	1	0	0	0	1
Valet, The (La doublure)	1	0	0	0	0	1
Twelve O'Clock High	1	0	0	0	0	1
Death Wish	0	1	0	0	0	1
Bring It On: All or Nothing	0	0	0	1	0	1
Power of Nightmares, The: The Rise of the Politics of Fear	1	0	0	0	0	1
The Beguiled	0	0	1	0	0	1
Mighty Heart, A	0	1	0	0	0	1
Carnival Magic	0	0	0	0	1	1
Night, The (Notte, La)	0	1	0	0	0	1
Horse Soldiers, The	0	1	0	0	0	1
Broken Arrow	0	0	1	0	0	1
Magic Mike XXL	0	1	0	0	0	1
Dragon Ball Z Gaiden: The Plot to Destroy the Saiyans	0	1	0	0	0	1
Dragon Ball Z: Resurrection of F	0	1	0	0	0	1
Sorrow	0	0	0	0	1	1
My Voyage to Italy (Il mio viaggio in Italia)	0	0	1	0	0	1
I Know Who Killed Me	0	0	0	0	1	1
Tales of Manhattan	1	0	0	0	0	1
Fast Food, Fast Women	1	0	0	0	0	1
China Blue	0	1	0	0	0	1
Brice Man, The (Brice de Nice)	0	1	0	0	0	1
Last Legion, The	0	0	1	0	0	1
There Will Come a Day	0	1	0	0	0	1
The Opposite Sex	0	0	0	1	0	1
The Gallows	0	0	0	1	0	1
Tokyo Tribe	1	0	0	0	0	1
Feast	0	0	1	0	0	1
Joe Dirt 2: Beautiful Loser	0	0	0	0	1	1
Return to Treasure Island	1	0	0	0	0	1
Nasu: Summer in Andalusia	1	0	0	0	0	1
Daddy Day Camp	0	0	0	0	1	1
For the Boys	0	0	0	1	0	1
Dark Places	0	0	0	1	0	1
Embassy	0	1	0	0	0	1
Frankie and Johnny	0	0	1	0	0	1
Fellini Satyricon	0	1	0	0	0	1
Martin	0	1	0	0	0	1
Afro Samurai	0	0	1	0	0	1
Massu Engira Maasilamani	1	0	0	0	0	1
Death Sentence	0	1	0	0	0	1
Irrational Man	0	0	1	0	0	1
2 Days in Paris	0	1	0	0	0	1
Exte: Hair Extensions	0	0	1	0	0	1
Taxi 4	0	0	0	1	0	1
Behind the Mask: The Rise of Leslie Vernon	0	1	0	0	0	1
Ooops! Noah is Gone...	1	0	0	0	0	1
Brothers Solomon, The	0	0	0	0	1	1
Visit, The	0	0	0	1	0	1
Nines, The	0	0	1	0	0	1
	0	1	0	0	0	1
Ten, The	1	0	0	0	0	1
Gotti	0	0	1	0	0	1
Goodnight Mommy (Ich seh ich seh)	0	0	1	0	0	1
Chopper	0	0	0	1	0	1
Electroma	0	0	0	0	1	1
Requiem	0	1	0	0	0	1
No End in Sight	0	1	0	0	0	1
Brigham City	0	1	0	0	0	1
Beautiful Creatures	0	0	0	1	0	1
Henry & June	0	1	0	0	0	1
Just Visiting	0	0	0	1	0	1
December Boys	0	0	1	0	0	1
Shanghai Kiss	0	1	0	0	0	1
Gleaners & I, The (Les glaneurs et la glaneuse)	0	1	0	0	0	1
Keep the River on Your Right: A Modern Cannibal Tale	0	1	0	0	0	1
Unreasonable Man, An	0	1	0	0	0	1
Love and Other Disasters	0	0	1	0	0	1
Interview	0	0	1	0	0	1
Cashback	0	0	1	0	0	1
Seeker: The Dark Is Rising, The	0	0	0	0	1	1
Before We Go	0	1	0	0	0	1
Carabineers, The (Carabiniers, Les)	0	0	0	0	1	1
Crossfire	0	1	0	0	0	1
Colonia	0	0	0	1	0	1
Ghost in the Shell Arise - Border 2: Ghost Whispers	0	0	1	0	0	1
Weirdsville	0	0	1	0	0	1
10th & Wolf	1	0	0	0	0	1
Sherlock Holmes: Terror by Night	0	0	1	0	0	1
Mystère à la Tour Eiffel	1	0	0	0	0	1
River's Edge	0	1	0	0	0	1
Fracchia contro Dracula	0	1	0	0	0	1
Last Winter, The	0	1	0	0	0	1
Edge of Heaven, The (Auf der anderen Seite)	0	1	0	0	0	1
Death on the Nile	0	0	1	0	0	1
Always Watching: A Marble Hornets Story	0	0	0	1	0	1
My Kid Could Paint That	1	0	0	0	0	1
Stefan Zweig: Farewell to Europe	0	0	1	0	0	1
King of California	0	0	1	0	0	1
Losin' It	0	0	0	0	1	1
Before the Devil Knows You're Dead	0	0	1	0	0	1
Fuzz	0	0	1	0	0	1
Madly in Love	1	0	0	0	0	1
Battle Beyond the Stars	0	0	1	0	0	1
Real Life	0	0	1	0	0	1
Hollywood Chainsaw Hookers	1	0	0	0	0	1
Spy Who Came in from the Cold, The	0	0	0	0	1	1
Itty Bitty Titty Committee	0	1	0	0	0	1
Get on the Bus	0	0	0	1	0	1
Greatest Story Ever Told, The	0	0	1	0	0	1
Plain Clothes	0	0	1	0	0	1
Bishop's Wife, The	0	1	0	0	0	1
Tapeheads	0	0	0	1	0	1
Reform School Girls	1	0	0	0	0	1
Fugitive, The	0	0	1	0	0	1
Normal Life	0	0	1	0	0	1
Avalon	0	0	1	0	0	1
Long Night's Journey Into Day	0	1	0	0	0	1
A Wrinkle in Time	0	0	1	0	0	1
Love	1	0	0	0	0	1
The Runner	0	0	0	1	0	1
George Carlin: Jammin' in New York	1	0	0	0	0	1
Harrison Bergeron	0	0	0	1	0	1
I Served the King of England (Obsluhoval jsem anglického krále)	1	0	0	0	0	1
Awake	0	1	0	0	0	1
Margot at the Wedding	0	0	1	0	0	1
Price of Milk, The	1	0	0	0	0	1
Company Man	0	0	0	1	0	1
The Witch	0	1	0	0	0	1
Men & Chicken	0	1	0	0	0	1
Savages, The	0	1	0	0	0	1
The Escort	0	0	1	0	0	1
Family Guy Presents: Something, Something, Something, Dark Side	1	0	0	0	0	1
Secret Agent, The	0	0	1	0	0	1
Visit, The	0	1	0	0	0	1
The Prime Gig	0	0	1	0	0	1
My Blueberry Nights	0	1	0	0	0	1
Valentine	0	1	0	0	0	1
Secret in Their Eyes	0	0	0	1	0	1
Deaths of Ian Stone, The	0	0	1	0	0	1
No Man's Land	0	0	1	0	0	1
The Electric Hotel	0	1	0	0	0	1
Monster Squad, The	1	0	0	0	0	1
As You Like It	0	0	1	0	0	1
Drained (O cheiro do Ralo)	0	1	0	0	0	1
Jeff Ross Roasts Criminals: Live at Brazos County Jail	0	1	0	0	0	1
The Night Before	0	0	1	0	0	1
Made in Heaven	0	0	0	0	1	1
Dedication	0	1	0	0	0	1
Late Night with Conan O'Brien: The Best of Triumph the Insult Comic Dog	0	0	0	1	0	1
Water Horse: Legend of the Deep, The	0	1	0	0	0	1
Battle For Sevastopol	1	0	0	0	0	1
Cassandra's Dream	0	1	0	0	0	1
Ishtar	0	0	0	1	0	1
Watch on the Rhine	0	1	0	0	0	1
Get Me Roger Stone	0	0	1	0	0	1
Hollywood Shuffle	1	0	0	0	0	1
Hiding Out	0	0	0	1	0	1
The Lost Room	0	1	0	0	0	1
Gardens of Stone	0	0	1	0	0	1
Fourth Protocol, The	0	0	1	0	0	1
In the Name of the King: A Dungeon Siege Tale	0	0	0	0	1	1
Hatchet	0	1	0	0	0	1
Heaven and Earth (Ten to Chi to)	0	0	1	0	0	1
Cat Soup (Nekojiru-so)	0	1	0	0	0	1
First Sunday	0	1	0	0	0	1
Cop	0	0	0	1	0	1
Tangerine	1	0	0	0	0	1
Untraceable	0	0	1	0	0	1
Every Secret Thing	0	0	0	1	0	1
Born in East L.A.	0	0	0	1	0	1
Signal, The	0	1	0	0	0	1
964 Pinocchio	0	0	0	0	1	1
Rise of the Footsoldier	1	0	0	0	0	1
Best Seller	0	1	0	0	0	1
Eye See You (D-Tox)	0	0	1	0	0	1
Ladybird Ladybird	0	1	0	0	0	1
Guardians	0	0	1	0	0	1
Invincible Shaolin	0	1	0	0	0	1
Amazing Grace and Chuck	0	1	0	0	0	1
Sherlock Holmes and the Secret Weapon	0	0	1	0	0	1
Legend of Rita, The (Stille nach dem Schuß, Die)	0	0	1	0	0	1
Teeth	0	0	0	1	0	1
Air I Breathe, The	0	0	1	0	0	1
Suffragette	0	0	1	0	0	1
Taxi to the Dark Side	0	1	0	0	0	1
Foxy Brown	0	0	1	0	0	1
Coffy	0	1	0	0	0	1
Descent	0	0	0	0	1	1
College Road Trip	1	0	0	0	0	1
Fort Tilden	0	1	0	0	0	1
Doomsday	0	1	0	0	0	1
The Unauthorized Saved by the Bell Story	0	1	0	0	0	1
Mongol	0	0	1	0	0	1
War Room	0	0	0	0	1	1
War Dance	1	0	0	0	0	1
Horrors of Spider Island (Ein Toter Hing im Netz)	0	0	0	0	1	1
City of Men (Cidade dos Homens)	0	1	0	0	0	1
Friendly Persuasion	0	1	0	0	0	1
T2 3-D: Battle Across Time	0	1	0	0	0	1
Carandiru	1	0	0	0	0	1
Deathgasm	1	0	0	0	0	1
Snow Angels	0	0	1	0	0	1
Sherlock Holmes: The Woman in Green	0	1	0	0	0	1
Never Back Down	0	1	0	0	0	1
Cooties	0	1	0	0	0	1
Autumn Marathon	0	1	0	0	0	1
Youth Without Youth	0	0	1	0	0	1
12 Chairs	1	0	0	0	0	1
Everlasting Piece, An	0	1	0	0	0	1
Ordinary Miracle	1	0	0	0	0	1
Shepherd: Border Patrol, The	0	0	1	0	0	1
Assembly (Ji jie hao)	1	0	0	0	0	1
Old Men: Robbers	0	1	0	0	0	1
Breakin' All the Rules	0	1	0	0	0	1
Last Year's Snow Was Falling	1	0	0	0	0	1
Shine a Light	0	1	0	0	0	1
Inside (À l'intérieur)	0	1	0	0	0	1
It Can't Be!	1	0	0	0	0	1
Ruins, The	0	1	0	0	0	1
Street Kings	0	0	1	0	0	1
Visitor, The	1	0	0	0	0	1
99 francs	0	1	0	0	0	1
Happy-Go-Lucky	0	1	0	0	0	1
Davy Crockett, King of the Wild Frontier	0	0	1	0	0	1
Are You Scared?	0	1	0	0	0	1
12 Chairs	1	0	0	0	0	1
Outsourced	0	1	0	0	0	1
Expelled: No Intelligence Allowed	0	0	0	0	1	1
Steve Jobs: The Man in the Machine	0	1	0	0	0	1
Mudge Boy, The	0	0	1	0	0	1
Redbelt	0	0	1	0	0	1
Bloodsucking Bastards	1	0	0	0	0	1
Bella	0	1	0	0	0	1
Investigation Held by Kolobki	1	0	0	0	0	1
Shelter	0	1	0	0	0	1
Karlson Returns	1	0	0	0	0	1
Love, Simon	0	1	0	0	0	1
Nina's Heavenly Delights	0	1	0	0	0	1
Bigger, Stronger, Faster*	0	1	0	0	0	1
All the Boys Love Mandy Lane	0	0	1	0	0	1
Recount	0	1	0	0	0	1
Ex Drummer	1	0	0	0	0	1
Stuck	0	1	0	0	0	1
Protector, The	0	0	0	1	0	1
Chaos Theory	0	1	0	0	0	1
Saving Christmas	0	0	0	0	1	1
Boy A	0	1	0	0	0	1
Spiral	1	0	0	0	0	1
Children of Huang Shi, The	0	1	0	0	0	1
Alpha	1	0	0	0	0	1
St. Trinian's	0	0	1	0	0	1
Oscar	1	0	0	0	0	1
Iron Man & Hulk: Heroes United	0	0	1	0	0	1
Strange Circus (Kimyô na sâkasu)	0	1	0	0	0	1
Zombie Strippers!	0	0	0	0	1	1
Frosty the Snowman	0	0	0	1	0	1
Battle for Haditha	0	1	0	0	0	1
Little Vampire, The	0	0	1	0	0	1
Infinity	0	0	1	0	0	1
Rogue	0	1	0	0	0	1
Knock Knock	0	0	0	1	0	1
Miracle of Morgan's Creek, The	0	1	0	0	0	1
Mr. Skeffington	1	0	0	0	0	1
Shrooms	0	1	0	0	0	1
Bliss	0	0	1	0	0	1
Strange Love of Martha Ivers, The	0	1	0	0	0	1
Vacations in Prostokvashino	1	0	0	0	0	1
Cornered!	1	0	0	0	0	1
Ghoulies II	0	0	0	1	0	1
Transsiberian	0	0	1	0	0	1
Billy Jack Goes to Washington	0	0	0	1	0	1
Winter in Prostokvashino	1	0	0	0	0	1
Stargate: Continuum	0	0	1	0	0	1
Shotgun Stories	0	0	1	0	0	1
Watching the Detectives	1	0	0	0	0	1
Two Family House	1	0	0	0	0	1
Musa the Warrior (Musa)	1	0	0	0	0	1
Little Drummer Boy, The	0	0	1	0	0	1
Hogfather (Terry Pratchett's Hogfather)	0	1	0	0	0	1
Picnic	0	0	1	0	0	1
Pathology	0	1	0	0	0	1
Digimon: The Movie	0	0	1	0	0	1
Tracey Fragments, The	0	0	1	0	0	1
Sorority House Massacre II	1	0	0	0	0	1
Sorority House Massacre	1	0	0	0	0	1
Slumber Party Massacre III	1	0	0	0	0	1
Slumber Party Massacre II	1	0	0	0	0	1
Great Expectations	0	1	0	0	0	1
Nothing Personal	0	0	1	0	0	1
Killer Shrews, The	0	0	0	0	1	1
Farewell to Arms, A	0	0	1	0	0	1
Edge of Love, The	0	0	1	0	0	1
Cigarette Burns	0	0	1	0	0	1
Heart of a Dog (Sobachye serdtse)	0	1	0	0	0	1
Frozen River	1	0	0	0	0	1
Voyage to the Bottom of the Sea	0	0	1	0	0	1
Walker, The	0	0	0	1	0	1
Bikini Beach	0	0	0	0	1	1
Faraway, So Close (In weiter Ferne, so nah!)	0	1	0	0	0	1
Hellraiser III: Hell on Earth	0	0	1	0	0	1
Sisterhood of the Traveling Pants 2, The	0	0	1	0	0	1
Hell Ride	0	0	0	1	0	1
High School Musical 2	0	0	0	1	0	1
Henry Poole is Here	0	1	0	0	0	1
Broken Hearts Club, The	0	1	0	0	0	1
Code 46	1	0	0	0	0	1
Mutant Chronicles	0	1	0	0	0	1
Hamlet 2	0	0	0	1	0	1
Beat the Devil	0	1	0	0	0	1
Jefferson in Paris	0	0	1	0	0	1
Story of Women (Affaire de femmes, Une)	1	0	0	0	0	1
Into the Forest	0	0	0	1	0	1
Crime and Punishment in Suburbia	0	1	0	0	0	1
Circus	0	0	0	0	1	1
The Editor	1	0	0	0	0	1
I.O.U.S.A. (a.k.a. IOUSA)	0	1	0	0	0	1
Mirrors	0	0	0	1	0	1
Watcher, The	0	0	0	1	0	1
Solas	0	1	0	0	0	1
Somers Town	0	1	0	0	0	1
Onion Movie, The	0	1	0	0	0	1
Skipped Parts	0	1	0	0	0	1
Priklyucheniya Kapitana Vrungelya	1	0	0	0	0	1
Inspector General, The	0	0	1	0	0	1
Little Lord Fauntleroy	0	1	0	0	0	1
Of Human Bondage	0	1	0	0	0	1
Penny Serenade	0	1	0	0	0	1
Suddenly, Last Summer	0	1	0	0	0	1
Sunflower (Xiang ri kui)	0	0	0	1	0	1
Our Town	0	0	1	0	0	1
Altered	0	0	1	0	0	1
Righteous Kill	0	0	1	0	0	1
Stranger, The	0	0	1	0	0	1
Pawn Sacrifice	0	0	1	0	0	1
Crow, The: Wicked Prayer	0	0	0	0	1	1
This So-Called Disaster	0	1	0	0	0	1
Appaloosa	0	0	1	0	0	1
Ryuzo and the Seven Henchmen	1	0	0	0	0	1
Dead Fury	0	0	1	0	0	1
Bless the Child	0	1	0	0	0	1
If I Were a Rich Man	0	0	1	0	0	1
Sound of the Mountain (Thunder of the Mountain, The) (Yama no oto)	1	0	0	0	0	1
I'm the One That I Want	1	0	0	0	0	1
Last Shift	0	1	0	0	0	1
Ilsa, She Wolf of the SS	0	0	0	1	0	1
Alone in the Dark II	0	1	0	0	0	1
And God Created Woman (Et Dieu... créa la femme)	0	1	0	0	0	1
F*ck You, Goethe 2	0	0	0	0	1	1
Garam Masala	1	0	0	0	0	1
W.	0	0	1	0	0	1
Secret Life of Bees, The	0	1	0	0	0	1
Tickling Giants	1	0	0	0	0	1
Phantasm III: Lord of the Dead	0	0	0	1	0	1
Hommage à Zgougou (et salut à Sabine Mamou)	0	0	0	0	1	1
American Carol, An	0	0	0	1	0	1
Tokyo-Ga	0	0	1	0	0	1
Life Eternal	0	0	1	0	0	1
I Kill Giants	0	0	0	1	0	1
Black Sabbath (Tre volti della paura, I)	0	1	0	0	0	1
Angus, Thongs and Perfect Snogging	0	0	1	0	0	1
Anti-Social	0	0	0	1	0	1
Lady from Shanghai, The	0	1	0	0	0	1
Express, The	0	0	1	0	0	1
Babylon 5: The Legend of the Rangers: To Live and Die in Starlight	0	1	0	0	0	1
Babylon 5: The Lost Tales - Voices in the Dark	0	1	0	0	0	1
Jump In!	1	0	0	0	0	1
Three Musketeers, The	0	1	0	0	0	1
Blindness	0	1	0	0	0	1
Vovka in the Kingdom of Far Far Away	1	0	0	0	0	1
Official Story, The (La historia oficial)	0	1	0	0	0	1
Tokyo!	0	1	0	0	0	1
Adventures of Mowgli: The Kidnapping	1	0	0	0	0	1
Unfaithfully Yours	1	0	0	0	0	1
Cinderella	0	0	1	0	0	1
A Detective Story	1	0	0	0	0	1
Narcopolis	0	0	0	1	0	1
Two Women (Ciociara, La)	0	1	0	0	0	1
Sinbad and the Eye of the Tiger	0	0	1	0	0	1
Mackenna's Gold	0	0	1	0	0	1
Krabat	0	0	0	1	0	1
Camp Rock	0	0	0	0	1	1
The Island	0	1	0	0	0	1
Tattooed Life (Irezumi ichidai)	0	0	1	0	0	1
Final Flight of the Osiris	0	1	0	0	0	1
Five Senses, The	1	0	0	0	0	1
Suspect Zero	0	1	0	0	0	1
Going in Style	0	0	1	0	0	1
Duel in the Sun	1	0	0	0	0	1
Splinter	0	1	0	0	0	1
The Circle	0	0	1	0	0	1
Pawnbroker, The	0	1	0	0	0	1
Children, The	0	1	0	0	0	1
Munchies	0	0	0	1	0	1
Fireproof	0	0	0	0	1	1
Letter to Three Wives, A	0	1	0	0	0	1
	0	0	0	1	0	1
The Great Hypnotist	0	1	0	0	0	1
Pervert's Guide to Cinema, The	0	1	0	0	0	1
Into the Grizzly Maze	0	0	0	1	0	1
Kid's Story	0	0	1	0	0	1
Che: Part One	1	0	0	0	0	1
Gordy	0	0	1	0	0	1
Human	1	0	0	0	0	1
Cheburashka	1	0	0	0	0	1
Che: Part Two	1	0	0	0	0	1
Foreign Correspondent	0	1	0	0	0	1
Sword of the Stranger (Sutorejia: Mukô hadan)	0	1	0	0	0	1
Chasuke's Journey	0	1	0	0	0	1
Blood In, Blood Out	0	1	0	0	0	1
Fluke	0	1	0	0	0	1
Game Over, Man!	0	0	1	0	0	1
Golden Bowl, The	0	1	0	0	0	1
Ben X	0	1	0	0	0	1
L.A. Slasher	1	0	0	0	0	1
Blackadder's Christmas Carol	0	0	1	0	0	1
Wild Child	0	0	1	0	0	1
Zeitgeist: Addendum	1	0	0	0	0	1
How To Change The World	1	0	0	0	0	1
Just Eat It: A Food Waste Story	0	1	0	0	0	1
General Died at Dawn, The	0	0	0	0	1	1
Earthsea (Legend of Earthsea)	0	0	1	0	0	1
Bros Before Hos	0	0	1	0	0	1
Tale of Despereaux, The	0	0	1	0	0	1
Gamers, The: Dorkness Rising	0	0	1	0	0	1
Mesrine: Killer Instinct (L'instinct de mort)	0	1	0	0	0	1
Trouble in Paradise	0	1	0	0	0	1
Slow Learners	0	0	0	1	0	1
Lonely Are the Brave	0	1	0	0	0	1
Ace in the Hole (Big Carnival, The)	0	0	1	0	0	1
My Bloody Valentine 3-D	0	0	0	1	0	1
The Meyerowitz Stories	0	1	0	0	0	1
Battle in Seattle	0	1	0	0	0	1
Cutter's Way	0	0	1	0	0	1
Fire and Ice	0	0	0	1	0	1
Unforgiven	0	0	0	0	1	1
Revenge of the Nerds III: The Next Generation	0	1	0	0	0	1
Revenge of the Nerds IV: Nerds in Love	0	1	0	0	0	1
Notorious	0	0	1	0	0	1
Sex, Drugs & Taxation	1	0	0	0	0	1
Uninvited, The	0	1	0	0	0	1
Eden Lake	0	1	0	0	0	1
Sunshine	0	1	0	0	0	1
Sky High	0	0	0	1	0	1
Annie Get Your Gun	0	0	1	0	0	1
Fatal Beauty	0	0	0	0	1	1
Confessions of a Dangerous Mind	0	1	0	0	0	1
Clara's Heart	0	0	1	0	0	1
Long Walk Home, The	0	1	0	0	0	1
War Machine	0	1	0	0	0	1
Sarafina!	0	1	0	0	0	1
Tokyo Idols	1	0	0	0	0	1
Sleepwalkers	0	0	0	1	0	1
Those Magnificent Men in Their Flying Machines	0	0	1	0	0	1
Dead Like Me: Life After Death	0	1	0	0	0	1
Frontière(s)	0	1	0	0	0	1
11th Hour, The	0	1	0	0	0	1
Afro Samurai: Resurrection	0	0	1	0	0	1
My Name Is Bruce	0	0	1	0	0	1
The Perfect Guy	0	0	0	1	0	1
Nuremberg	0	1	0	0	0	1
Brother from Another Planet, The	0	0	1	0	0	1
Rock the Kasbah	0	0	0	1	0	1
Freaks of Nature	1	0	0	0	0	1
Prey for Rock & Roll	0	0	0	1	0	1
Vir Das: Abroad Understanding	0	1	0	0	0	1
Extraordinary Tales	0	0	1	0	0	1
The Dressmaker	0	0	1	0	0	1
Rock-A-Doodle	0	0	0	1	0	1
Class of Nuke 'Em High	0	0	1	0	0	1
Private School	0	0	1	0	0	1
Nowitzki: The Perfect Shot	0	1	0	0	0	1
Dance of the Dead	0	1	0	0	0	1
Who's That Knocking at My Door?	0	0	0	0	1	1
Light Years (Gandahar)	1	0	0	0	0	1
Duplicity	0	0	1	0	0	1
Echelon Conspiracy	0	0	0	1	0	1
Baader Meinhof Komplex, Der	0	1	0	0	0	1
Trumbo	0	1	0	0	0	1
Strictly Sexual	1	0	0	0	0	1
Our Lips Are Sealed	0	1	0	0	0	1
Decline of Western Civilization Part II: The Metal Years, The	0	0	1	0	0	1
Idaho Transfer	0	0	0	0	1	1
Man with the Golden Arm, The	1	0	0	0	0	1
The Butterfly Effect 3: Revelations	0	0	0	0	1	1
Man on the Flying Trapeze	1	0	0	0	0	1
Witch Hunt	0	0	1	0	0	1
For the Love of Benji	0	1	0	0	0	1
Peanuts Movie, The	0	0	0	1	0	1
Bloodsport: The Dark Kumite	0	0	0	0	1	1
Sin Nombre	0	1	0	0	0	1
Stay Tuned	0	0	1	0	0	1
Great Buck Howard, The	0	1	0	0	0	1
Rent-A-Cop	0	0	0	0	1	1
Puppet Master 5: The Final Chapter	0	0	0	1	0	1
Puppet Master 4	0	0	0	1	0	1
Formula of Love	1	0	0	0	0	1
Puppet Master II	0	0	1	0	0	1
A Man from Boulevard des Capucines	0	1	0	0	0	1
Quatermass and the Pit	0	0	1	0	0	1
The Adventures of Sherlock Holmes and Dr. Watson: The Hound of the Baskervilles	0	1	0	0	0	1
Flatfoot on the Nile (Piedone d'Egitto)	0	0	0	1	0	1
Norm Macdonald: Hitler's Dog, Gossip & Trickery	0	0	1	0	0	1
City of the Living Dead (a.k.a. Gates of Hell, The) (Paura nella città dei morti viventi)	0	0	1	0	0	1
Earth	0	1	0	0	0	1
Abominable Snowman, The (Abominable Snowman of the Himalayas, The)	0	1	0	0	0	1
Stanley Kubrick: A Life in Pictures	0	1	0	0	0	1
Camera Buff (Amator)	0	0	1	0	0	1
M. Butterfly	0	0	1	0	0	1
King in New York, A	0	1	0	0	0	1
Crossing Over	0	0	0	1	0	1
Scorpio	0	1	0	0	0	1
Vagabond (Sans toit ni loi)	1	0	0	0	0	1
Balls Out: Gary the Tennis Coach	0	0	0	1	0	1
Seven Days in May	0	1	0	0	0	1
Powder Blue	0	0	0	1	0	1
Were the World Mine	0	1	0	0	0	1
Paisan (Paisà)	0	1	0	0	0	1
Blockers	0	0	1	0	0	1
I Do: How to Get Married and Stay Single (Prête-moi ta main)	0	1	0	0	0	1
The Gracefield Incident	0	0	0	0	1	1
Better Living Through Circuitry	0	0	0	1	0	1
Blue Mountain State: The Rise of Thadland	0	0	1	0	0	1
Dil To Pagal Hai	0	1	0	0	0	1
Twelve Chairs, The	0	0	1	0	0	1
Hollywood Knights, The	0	0	0	1	0	1
1-900 (06)	0	1	0	0	0	1
In the Electric Mist	0	0	0	1	0	1
Killshot	0	0	1	0	0	1
Sweeney Todd	0	1	0	0	0	1
Boy Eats Girl	1	0	0	0	0	1
Regret to Inform	0	1	0	0	0	1
Marius and Jeanette (Marius et Jeannette)	0	1	0	0	0	1
Ernest Rides Again	0	0	0	0	1	1
Gypsy	0	0	0	0	1	1
Special	0	1	0	0	0	1
Shadow World	1	0	0	0	0	1
My Flesh and Blood	0	1	0	0	0	1
Screwed	0	0	0	0	1	1
Imagine That	0	1	0	0	0	1
Stoning of Soraya M., The	1	0	0	0	0	1
Time Masters (Maîtres du temps, Les)	1	0	0	0	0	1
The Boy and the Beast	0	1	0	0	0	1
Lords of Flatbush, The	0	0	0	1	0	1
Come Back, Little Sheba	0	1	0	0	0	1
The Idolmaker	0	1	0	0	0	1
Garfield's Pet Force	1	0	0	0	0	1
Trigger Effect, The	0	0	0	1	0	1
Dragons: Gift of the Night Fury	1	0	0	0	0	1
Breakfast with Scot	0	1	0	0	0	1
Twinsters	0	1	0	0	0	1
Cosmic Scrat-tastrophe	1	0	0	0	0	1
Carnosaur 3: Primal Species	0	0	0	0	1	1
Supercop 2 (Project S) (Chao ji ji hua)	1	0	0	0	0	1
Nothing to Lose	0	1	0	0	0	1
Orca: The Killer Whale	0	0	0	1	0	1
Rampage	0	0	1	0	0	1
Smiling Fish and Goat on Fire	0	1	0	0	0	1
Bossa Nova	1	0	0	0	0	1
United States of Leland, The	0	1	0	0	0	1
Prison Break: The Final Break	0	1	0	0	0	1
Daria: Is It College Yet?	0	0	0	0	1	1
Wow! A Talking Fish!	1	0	0	0	0	1
Travels of an Ant	1	0	0	0	0	1
My Sister's Keeper	0	1	0	0	0	1
Hood of Horror	1	0	0	0	0	1
Watchmen: Tales of the Black Freighter	0	1	0	0	0	1
The Adventures of Sherlock Holmes and Doctor Watson: The Hunt for the Tiger	1	0	0	0	0	1
Solace	0	0	0	1	0	1
Eichmann	1	0	0	0	0	1
Open Water 2: Adrift	0	0	1	0	0	1
9to5: Days in Porn (a.k.a. 9 to 5: Days in Porn)	0	1	0	0	0	1
Humpday	0	0	1	0	0	1
Polytechnique	0	0	0	1	0	1
Lost in the Sun	0	0	0	1	0	1
Collector, The	0	1	0	0	0	1
Gintama	1	0	0	0	0	1
Perfect Getaway, A	0	1	0	0	0	1
Le Maître d'école	0	1	0	0	0	1
Obsessed	0	1	0	0	0	1
Fugitives	1	0	0	0	0	1
Eros	0	1	0	0	0	1
Hannah Montana: The Movie	0	1	0	0	0	1
Max Manus	1	0	0	0	0	1
All the Vermeers in New York	1	0	0	0	0	1
Winds of the Wasteland	0	1	0	0	0	1
Deal, The	0	0	0	1	0	1
I Can't Think Straight	0	1	0	0	0	1
I Love You, Beth Cooper	0	0	1	0	0	1
Those Happy Days	0	0	1	0	0	1
G-Force	0	1	0	0	0	1
Christopher Columbus: The Discovery	0	0	0	1	0	1
Tetro	1	0	0	0	0	1
The Girls	1	0	0	0	0	1
My Life in Ruins	0	0	0	1	0	1
Joe Gould's Secret	0	0	1	0	0	1
If These Walls Could Talk	0	0	1	0	0	1
White Ribbon, The (Das weiße Band)	1	0	0	0	0	1
Green Lantern: First Flight	0	1	0	0	0	1
	1	0	0	0	0	1
Death of a Cyclist (Muerte de un ciclista)	0	0	1	0	0	1
Hunt For Gollum, The	0	0	1	0	0	1
What Men Still Talk About	0	1	0	0	0	1
1492: Conquest of Paradise	0	0	1	0	0	1
Tyler Perry's I Can Do Bad All by Myself	1	0	0	0	0	1
Attack of the 50 Foot Woman	1	0	0	0	0	1
Tiger Raid	0	0	0	1	0	1
Bright Star	0	1	0	0	0	1
Blood Creek (a.k.a. Town Creek)	0	0	1	0	0	1
The Adventures of Sherlock Holmes and Doctor Watson: The Treasures of Agra	1	0	0	0	0	1
Still Walking (Aruitemo aruitemo)	0	0	0	0	1	1
Blood of the Beasts (Sang des bêtes, Le)	0	1	0	0	0	1
Madame Sousatzka	1	0	0	0	0	1
City Island	0	1	0	0	0	1
Son of the Sheik, The	0	1	0	0	0	1
Ink	0	1	0	0	0	1
Metropia	0	0	1	0	0	1
Haunted World of El Superbeasto, The	0	1	0	0	0	1
Trick 'r Treat	0	0	1	0	0	1
Gulliver's Travels	0	0	0	1	0	1
Assassination of a High School President	0	0	0	0	1	1
Coco Before Chanel (Coco avant Chanel)	0	1	0	0	0	1
Burma VJ: Reporting from a Closed Country (Burma VJ: Reporter i et lukket land)	0	1	0	0	0	1
Adventures Of Sherlock Holmes And Dr. Watson: The Twentieth Century Approaches	1	0	0	0	0	1
The Adventures of Sherlock Holmes and Doctor Watson: King of Blackmailers	1	0	0	0	0	1
Retroactive	0	1	0	0	0	1
The Adventures of Sherlock Holmes and Dr. Watson: Bloody Signature	1	0	0	0	0	1
Legionnaire	0	0	0	0	1	1
Misfortunates, The (De helaasheid der dingen)	0	0	1	0	0	1
Spread	0	1	0	0	0	1
Tournament, The	0	0	1	0	0	1
Princess and the Pirate, The	0	1	0	0	0	1
Aelita: The Queen of Mars (Aelita)	1	0	0	0	0	1
Balance	1	0	0	0	0	1
Love Exposure (Ai No Mukidashi)	1	0	0	0	0	1
Gothic	0	1	0	0	0	1
Buddy Boy	0	0	1	0	0	1
Sherlock Holmes and Dr. Watson: Acquaintance	1	0	0	0	0	1
Raise Your Voice	1	0	0	0	0	1
Cirque du Freak: The Vampire's Assistant	0	0	0	1	0	1
King Solomon's Mines	0	0	1	0	0	1
Welcome to Dongmakgol	1	0	0	0	0	1
Good Mother, The	0	1	0	0	0	1
Ned Kelly	0	0	1	0	0	1
A Perfect Day	1	0	0	0	0	1
Masked Avengers	0	1	0	0	0	1
Return of the One-Armed Swordsman	0	0	1	0	0	1
Kaspar Hauser	0	1	0	0	0	1
Band of the Hand	0	0	0	0	1	1
Private Lives of Pippa Lee, The	0	1	0	0	0	1
Collector, The (La collectionneuse)	0	1	0	0	0	1
Derailed	0	0	0	0	1	1
Messenger, The	0	1	0	0	0	1
Cell 211 (Celda 211)	1	0	0	0	0	1
Patriot, The	0	1	0	0	0	1
Death Wish 5: The Face of Death	0	0	0	0	1	1
Death Wish 4: The Crackdown	0	0	0	0	1	1
The Lord's Lantern in Budapest	1	0	0	0	0	1
Hitchcock/Truffaut	0	1	0	0	0	1
Teenage Mutant Ninja Turtles: Turtles Forever	0	0	1	0	0	1
Merry Madagascar	0	0	1	0	0	1
Champ, The	0	0	1	0	0	1
Garage	0	1	0	0	0	1
Mickey's Once Upon a Christmas	1	0	0	0	0	1
Shrink	0	0	0	1	0	1
Atomic Blonde	0	0	1	0	0	1
Old Dogs	0	0	0	0	1	1
Earthlings	0	1	0	0	0	1
Castle Freak	0	0	1	0	0	1
Peacekeeper, The	0	0	0	0	1	1
Crimson Pirate, The	0	0	1	0	0	1
Cure, The	0	0	1	0	0	1
Love Is a Many-Splendored Thing	0	1	0	0	0	1
Did You Hear About the Morgans?	0	0	1	0	0	1
Soft Fruit	0	1	0	0	0	1
Snow White	0	1	0	0	0	1
Alice	0	1	0	0	0	1
Empties	1	0	0	0	0	1
Night to Remember, A	0	0	1	0	0	1
Sorority Babes in the Slimeball Bowl-O-Rama	0	0	1	0	0	1
Raise the Titanic	0	1	0	0	0	1
Stage Beauty	0	1	0	0	0	1
A Very Murray Christmas	0	0	1	0	0	1
We're Back! A Dinosaur's Story	0	0	1	0	0	1
Eulogy	0	0	1	0	0	1
Staten Island	0	0	0	1	0	1
Maiden Heist, The	0	0	1	0	0	1
Goon: Last of the Enforcers	0	1	0	0	0	1
Blood: The Last Vampire	0	0	0	1	0	1
Belladonna of Sadness	0	1	0	0	0	1
MacGyver: Lost Treasure of Atlantis	0	1	0	0	0	1
American Buffalo	0	0	0	1	0	1
Shanghai Surprise	0	0	0	1	0	1
Let's Get Harry	0	0	0	1	0	1
Pekka ja Pätkä Suezilla	0	1	0	0	0	1
Bart Got a Room	0	1	0	0	0	1
Never Die Alone	0	1	0	0	0	1
Robin-B-Hood (Bo bui gai wak)	0	0	1	0	0	1
Concert, Le	0	0	1	0	0	1
On the Beach	1	0	0	0	0	1
Ogre, The (Unhold, Der)	0	1	0	0	0	1
Daughters of the Dust	0	1	0	0	0	1
Truth	0	0	1	0	0	1
Walking and Talking	0	1	0	0	0	1
Just Jim	0	0	1	0	0	1
Ninja	0	0	1	0	0	1
The Putin Interviews	0	0	1	0	0	1
Asterix at the Olympic Games (Astérix aux jeux olympiques)	0	1	0	0	0	1
Chaser, The (Chugyeogja)	0	0	1	0	0	1
Meantime	1	0	0	0	0	1
Dennis the Menace Christmas, A	0	0	0	1	0	1
Undisputed II: Last Man Standing	0	1	0	0	0	1
Applesauce	1	0	0	0	0	1
East-West (Est-ouest)	0	1	0	0	0	1
Young and the Damned, The (Olvidados, Los)	0	1	0	0	0	1
Peter Pan	0	1	0	0	0	1
Closer You Get, The	1	0	0	0	0	1
John Mulaney: The Comeback Kid	0	1	0	0	0	1
Wicked City (Yôjû toshi)	0	0	1	0	0	1
Charlie, the Lonesome Cougar	0	0	1	0	0	1
Blood Feast	0	1	0	0	0	1
Dream of Light (a.k.a. Quince Tree Sun, The) (Sol del membrillo, El)	1	0	0	0	0	1
Country Girl, The	0	1	0	0	0	1
Intermission	0	1	0	0	0	1
My Tutor	0	0	0	1	0	1
Last Klezmer: Leopold Kozlowski, His Life and Music, The	0	1	0	0	0	1
The Year My Voice Broke	0	1	0	0	0	1
Unforgettable Summer, An (Un été inoubliable)	0	0	0	1	0	1
Captain Newman, M.D.	1	0	0	0	0	1
Unedited Footage of a Bear	0	1	0	0	0	1
Gintama: The Movie	0	1	0	0	0	1
North Pole: Open For Christmas	0	0	0	1	0	1
Chain of Fools	0	1	0	0	0	1
House of the Devil, The	0	1	0	0	0	1
Mojave	0	0	0	1	0	1
Happy Go Lovely	1	0	0	0	0	1
Wizards of Waverly Place: The Movie	0	1	0	0	0	1
Rose Tattoo, The	0	1	0	0	0	1
Spy Next Door, The	0	0	0	1	0	1
Agora	0	1	0	0	0	1
Motherhood	0	0	0	0	1	1
Black Tar Heroin: The Dark End of the Street	1	0	0	0	0	1
Blue Exorcist: The Movie	0	1	0	0	0	1
Devil Dog: The Hound of Hell	0	1	0	0	0	1
Yes Men Fix the World, The	0	1	0	0	0	1
Obsession	1	0	0	0	0	1
Mike Bassett: England Manager	0	1	0	0	0	1
Dear John	0	1	0	0	0	1
Raining Stones	0	1	0	0	0	1
Eaten Alive	0	0	0	1	0	1
Not One Less (Yi ge dou bu neng shao)	1	0	0	0	0	1
anohana: The Flower We Saw That Day - The Movie	0	0	1	0	0	1
Last Train Home	0	0	1	0	0	1
He Never Died	0	1	0	0	0	1
They Might Be Giants	0	0	1	0	0	1
Parasyte: Part 1	0	1	0	0	0	1
Brandon Teena Story, The	0	0	0	1	0	1
Baby, The	0	0	0	1	0	1
Gun Shy	0	0	0	0	1	1
Decline of the American Empire, The (Déclin de l'empire américain, Le)	0	1	0	0	0	1
Parasyte: Part 2	0	1	0	0	0	1
Spirits of the Dead	0	0	1	0	0	1
Remember Me	0	1	0	0	0	1
Burrowers, The	0	0	1	0	0	1
Touki Bouki	0	1	0	0	0	1
Generation X	0	0	0	1	0	1
Little Ashes	0	0	1	0	0	1
Our Family Wedding	0	0	0	1	0	1
Women in Trouble	0	0	0	1	0	1
Mondo Cane	0	0	0	1	0	1
Case 39	0	0	0	0	1	1
Oceans (Océans)	0	1	0	0	0	1
A Cosmic Christmas	0	1	0	0	0	1
Mother (Madeo)	1	0	0	0	0	1
Bone Man, The (Der Knochenmann)	1	0	0	0	0	1
	0	0	1	0	0	1
Emperor's New Groove 2: Kronk's New Groove, The	1	0	0	0	0	1
Steam of Life (Miesten vuoro)	0	1	0	0	0	1
Mortadelo & Filemon: The Big Adventure (La gran aventura de Mortadelo y Filemón)	0	1	0	0	0	1
American Drug War: The Last White Hope	0	0	1	0	0	1
Runaways, The	0	1	0	0	0	1
Wild China	0	1	0	0	0	1
Bebe's Kids	0	0	0	0	1	1
Valhalla Rising	0	0	1	0	0	1
Diary of a Wimpy Kid	0	1	0	0	0	1
Union: The Business Behind Getting High, The	0	1	0	0	0	1
Disgrace	0	1	0	0	0	1
Last Song, The	0	1	0	0	0	1
Cyrus	0	0	1	0	0	1
Human Centipede, The (First Sequence)	0	0	0	0	1	1
MacGruber	0	0	1	0	0	1
Lumberjack Man	1	0	0	0	0	1
'Tis the Season for Love	0	0	0	1	0	1
Three Men and a Cradle (3 hommes et un couffin)	1	0	0	0	0	1
Oh, Hello: On Broadway	0	1	0	0	0	1
Sky Crawlers, The (Sukai kurora)	0	0	1	0	0	1
Cargo	0	1	0	0	0	1
Peyton Place	0	1	0	0	0	1
Indignation	1	0	0	0	0	1
St Trinian's 2: The Legend of Fritton's Gold	0	0	0	1	0	1
12 Angry Men	1	0	0	0	0	1
Good Time	0	0	1	0	0	1
Ashes of Time (Dung che sai duk)	0	1	0	0	0	1
Lovers & Leavers (Kuutamolla)	0	1	0	0	0	1
Spellbound	1	0	0	0	0	1
Merantau	0	1	0	0	0	1
Stingray Sam	0	1	0	0	0	1
Unicorn City	1	0	0	0	0	1
Cemetery Junction	0	1	0	0	0	1
Won't You Be My Neighbor?	1	0	0	0	0	1
Shake Hands with the Devil	0	0	1	0	0	1
Please Give	0	1	0	0	0	1
Baarìa	1	0	0	0	0	1
Ricky Gervais Live: Animals	0	1	0	0	0	1
Standoff	0	0	1	0	0	1
Unthinkable	0	0	1	0	0	1
Terrorist, The (a.k.a. Malli) (Theeviravaathi)	0	0	1	0	0	1
Back-up Plan, The	0	0	1	0	0	1
Ricky Gervais Live 3: Fame	0	0	1	0	0	1
Scalphunters, The	1	0	0	0	0	1
Don Camillo in Moscow	0	0	1	0	0	1
Third Miracle, The	0	0	1	0	0	1
Barking Dogs Never Bite (Flandersui gae)	0	1	0	0	0	1
Swelter	0	0	0	1	0	1
The House	0	1	0	0	0	1
Best Worst Movie	0	1	0	0	0	1
Pride and Prejudice and Zombies	1	0	0	0	0	1
Endgame	0	0	1	0	0	1
Empire of Dreams: The Story of the 'Star Wars' Trilogy	1	0	0	0	0	1
When You're Strange	0	1	0	0	0	1
Garm Wars: The Last Druid	0	0	0	1	0	1
Room at the Top	0	1	0	0	0	1
Cherrybomb	0	0	1	0	0	1
No. 1 Ladies' Detective Agency, The	0	0	1	0	0	1
Watch Out for the Automobile (Beregis avtomobilya)	0	1	0	0	0	1
The Devil's Candy	0	0	0	1	0	1
Deadly Outlaw: Rekka (a.k.a. Violent Fire) (Jitsuroku Andô Noboru kyôdô-den: Rekka)	0	1	0	0	0	1
Simpatico	0	0	1	0	0	1
Element of Crime, The (Forbrydelsens Element)	0	1	0	0	0	1
Hellsinki (Rööperi)	0	0	1	0	0	1
Ramona and Beezus	0	0	1	0	0	1
Logan Lucky	1	0	0	0	0	1
Rebound, The	0	0	1	0	0	1
Two Escobars, The	0	1	0	0	0	1
Paper Man	0	1	0	0	0	1
The Love Bug	1	0	0	0	0	1
Heartless	0	0	1	0	0	1
Broken Wings (Knafayim Shvurot)	0	0	1	0	0	1
Andrew Dice Clay: Dice Rules	0	1	0	0	0	1
Get Low	1	0	0	0	0	1
Joneses, The	0	1	0	0	0	1
Total Eclipse	0	0	1	0	0	1
Hell in the Pacific	0	0	1	0	0	1
Dragon Ball Z: Dead Zone (Doragon bôru Z 1: Ora no Gohan wo kaese)	0	1	0	0	0	1
Moonwalkers	0	0	1	0	0	1
Last Dance	0	0	1	0	0	1
Three Wishes	0	0	1	0	0	1
Last Exorcism, The	0	1	0	0	0	1
Daddy Long Legs	0	0	0	1	0	1
Sisters (Syostry)	1	0	0	0	0	1
The Dark Tower	0	1	0	0	0	1
Annabelle: Creation	0	1	0	0	0	1
End of the Affair, The	0	1	0	0	0	1
Tomorrow	1	0	0	0	0	1
Horde, The (La Horde)	0	0	1	0	0	1
Princess (Prinsessa)	0	0	1	0	0	1
Man Vanishes, A (Ningen Johatsu)	0	1	0	0	0	1
Anacleto: Agente secreto	0	1	0	0	0	1
'night Mother	0	0	1	0	0	1
Howl	0	1	0	0	0	1
I'm Still Here	0	1	0	0	0	1
Patrik Age 1.5 (Patrik 1,5)	0	1	0	0	0	1
Haunted World of Edward D. Wood Jr., The	0	1	0	0	0	1
Come See the Paradise	0	0	0	0	1	1
Wiener-Dog	0	0	1	0	0	1
Alice in Wonderland	0	1	0	0	0	1
Maggie's Plan	0	0	0	1	0	1
Sintel	0	1	0	0	0	1
Secretariat	0	0	1	0	0	1
The Flash 2 - Revenge of the Trickster	0	0	0	1	0	1
You Again	0	1	0	0	0	1
You Will Meet a Tall Dark Stranger	0	1	0	0	0	1
Gena the Crocodile	1	0	0	0	0	1
My Man Godfrey	1	0	0	0	0	1
Sorry to Bother You	1	0	0	0	0	1
Exposed	0	0	0	1	0	1
Monsters	0	1	0	0	0	1
Luck by Chance	1	0	0	0	0	1
Stonewall	0	0	1	0	0	1
Waiting for 'Superman'	0	1	0	0	0	1
In a Better World (Hævnen)	0	1	0	0	0	1
Heartbreaker (L'Arnacoeur)	0	0	1	0	0	1
Babes in Toyland	1	0	0	0	0	1
Frankenstein	0	0	0	1	0	1
Hereafter	0	1	0	0	0	1
Undisputed III: Redemption	0	1	0	0	0	1
Saw VII 3D - The Final Chapter	1	0	0	0	0	1
Welcome to Happiness	0	0	0	1	0	1
Risen	0	0	0	0	1	1
I Shot Jesse James	0	0	0	1	0	1
On the Trail of the Bremen Town Musicians	1	0	0	0	0	1
Certified Copy (Copie conforme)	0	1	0	0	0	1
Sandpiper, The	1	0	0	0	0	1
Somewhere	0	0	1	0	0	1
The Survivalist	0	1	0	0	0	1
First Beautiful Thing, The (La prima cosa bella)	0	1	0	0	0	1
Sunset Park	0	0	1	0	0	1
Romantics, The	0	0	1	0	0	1
Reptilicus	0	0	0	0	1	1
In the blue sea, in the white foam.	1	0	0	0	0	1
Goat	0	0	1	0	0	1
Vincent Wants to Sea (Vincent will meer)	0	0	1	0	0	1
London Boulevard	0	0	0	1	0	1
Skyline	0	0	0	0	1	1
Where's Marlowe?	0	1	0	0	0	1
Oxygen	0	1	0	0	0	1
Wolf and Calf	0	1	0	0	0	1
Beastly	0	1	0	0	0	1
Requiem for the American Dream	0	0	1	0	0	1
Hatchet II	1	0	0	0	0	1
Bobik Visiting Barbos	1	0	0	0	0	1
The Magic Ring	1	0	0	0	0	1
Delta of Venus	0	0	0	0	1	1
Tarnation	0	1	0	0	0	1
Barney's Version	0	1	0	0	0	1
Meatballs 4	0	0	0	0	1	1
Star Is Born, A	0	1	0	0	0	1
Company Men, The	0	0	1	0	0	1
One-Armed Swordsman, The (Dubei dao)	0	0	1	0	0	1
Trash Humpers	0	0	0	0	1	1
Faster	1	0	0	0	0	1
Little Big Soldier (Da bing xiao jiang)	0	1	0	0	0	1
Rabbit Hole	0	1	0	0	0	1
One Week	0	1	0	0	0	1
Sweetgrass	1	0	0	0	0	1
Burlesque	0	0	1	0	0	1
Made in Dagenham	0	0	0	1	0	1
Way Back, The	0	1	0	0	0	1
Warrior's Way, The	0	1	0	0	0	1
Season of the Witch	0	1	0	0	0	1
Three from Prostokvashino	1	0	0	0	0	1
Amer	0	0	0	0	1	1
Anything for Her (Pour elle)	0	0	1	0	0	1
Funhouse, The	0	0	0	1	0	1
The Finest Hours	0	0	1	0	0	1
Dogman	0	1	0	0	0	1
Down Argentine Way	1	0	0	0	0	1
Trip, The	0	1	0	0	0	1
Happy People: A Year in the Taiga	1	0	0	0	0	1
Reckless	0	0	1	0	0	1
Bustin' Loose	0	0	0	1	0	1
Bride of Re-Animator	0	1	0	0	0	1
Ghost in the Shell: Solid State Society	0	1	0	0	0	1
Rosetta	0	1	0	0	0	1
Last Night	0	1	0	0	0	1
Even the Rain (También la lluvia)	0	1	0	0	0	1
It Happened on Fifth Avenue	1	0	0	0	0	1
Zeitgeist: Moving Forward	1	0	0	0	0	1
Agent Cody Banks 2: Destination London	0	1	0	0	0	1
Wrong Arm of the Law, The	0	1	0	0	0	1
My Best Fiend (Mein liebster Feind)	0	1	0	0	0	1
Girls About Town	1	0	0	0	0	1
Kill! (Kiru)	0	0	1	0	0	1
Pekka ja Pätkä salapoliiseina	0	1	0	0	0	1
Run of the Country, The	0	1	0	0	0	1
Gnomeo & Juliet	0	0	1	0	0	1
Rawhead Rex	0	1	0	0	0	1
Burke and Hare	0	1	0	0	0	1
Castaway on the Moon (Kimssi pyoryugi)	0	1	0	0	0	1
Asphyx, The	1	0	0	0	0	1
The Emoji Movie	0	0	0	0	1	1
Brother 2 (Brat 2)	1	0	0	0	0	1
Gods of Egypt	0	0	0	0	1	1
Embrace of the Serpent	0	1	0	0	0	1
On Any Sunday	1	0	0	0	0	1
Ipcress File, The	0	1	0	0	0	1
Guardian, The	0	0	0	1	0	1
Body Shots	0	0	1	0	0	1
Take Me Home Tonight	0	0	1	0	0	1
Race	0	0	0	1	0	1
Confessions (Kokuhaku)	0	1	0	0	0	1
Best Man, The	0	0	1	0	0	1
Bats	0	0	1	0	0	1
Eagle, The	0	0	0	1	0	1
Red Sorghum (Hong gao liang)	1	0	0	0	0	1
Sunset Limited, The	0	1	0	0	0	1
Winnie the Pooh and the Honey Tree	0	1	0	0	0	1
Man and a Woman, A (Un homme et une femme)	1	0	0	0	0	1
Mars Needs Moms	0	1	0	0	0	1
Scooby-Doo! Curse of the Lake Monster	1	0	0	0	0	1
Winnie the Pooh and Tigger Too	0	1	0	0	0	1
Omega Code, The	0	0	0	1	0	1
Julien Donkey-Boy	0	0	0	0	1	1
Summer Place, A	0	0	1	0	0	1
Hard Ticket to Hawaii	0	0	0	0	1	1
Cave of Forgotten Dreams	0	0	1	0	0	1
Damned, The (La Caduta degli dei)	0	1	0	0	0	1
Big Mommas: Like Father, Like Son	0	0	0	0	1	1
Pickup on South Street	0	1	0	0	0	1
Jane Eyre	0	0	1	0	0	1
Desierto	0	0	1	0	0	1
Boy	0	1	0	0	0	1
Diary of a Wimpy Kid: Rodrick Rules	0	1	0	0	0	1
Henry's Crime	0	0	0	1	0	1
Mamma Mia: Here We Go Again!	1	0	0	0	0	1
Playing the Victim (Izobrazhaya zhertvu)	0	1	0	0	0	1
Rory Scovel Tries Stand-Up for the First Time	0	0	0	1	0	1
Films to Keep You Awake: The Christmas Tale (Películas para no dormir: Cuento de navidad)	0	0	0	0	1	1
Connections	1	0	0	0	0	1
Into Eternity	0	1	0	0	0	1
Daffy Duck's Quackbusters	0	0	0	1	0	1
Atlas Shrugged: Part 1	0	0	0	1	0	1
Mildred Pierce	1	0	0	0	0	1
Shot Caller	0	1	0	0	0	1
Rick and Morty: State of Georgia Vs. Denver Fenton Allen	0	0	1	0	0	1
Return with Honor	0	1	0	0	0	1
Dad's Army	1	0	0	0	0	1
Michael Jackson's Thriller	0	1	0	0	0	1
The Wait	0	1	0	0	0	1
African Cats	0	0	1	0	0	1
War and Peace	0	1	0	0	0	1
Louis Theroux: Law & Disorder	1	0	0	0	0	1
Idiots and Angels	1	0	0	0	0	1
Soul Surfer	0	1	0	0	0	1
Southbound	0	1	0	0	0	1
Mothra (Mosura)	0	0	1	0	0	1
Ip Man 3	0	1	0	0	0	1
Nothing to Declare (Rien à déclarer)	0	1	0	0	0	1
Across the Hall	0	0	0	1	0	1
Roommate, The	0	0	0	1	0	1
Cold Fever (Á köldum klaka)	0	0	1	0	0	1
Let the Bullets Fly	0	0	1	0	0	1
American Grindhouse	0	1	0	0	0	1
Santa's Little Helper	0	0	0	1	0	1
Who Killed Chea Vichea?	1	0	0	0	0	1
Run	0	1	0	0	0	1
Rabbits	0	1	0	0	0	1
Genius Party	0	0	1	0	0	1
Jack and Sarah	0	0	1	0	0	1
Dark Half, The	0	0	0	1	0	1
And the Ship Sails On (E la nave va)	0	1	0	0	0	1
Alvarez Kelly	0	0	1	0	0	1
Romance	0	1	0	0	0	1
Plunkett & MaCleane	0	0	1	0	0	1
New Rose Hotel	0	0	0	0	1	1
Long Live Ghosts!	0	0	1	0	0	1
Too Big to Fail	1	0	0	0	0	1
Frisk	0	0	1	0	0	1
My Life as McDull (Mak dau goo si)	1	0	0	0	0	1
Simon Sez	0	0	0	0	1	1
Passion of Anna, The (Passion, En)	0	1	0	0	0	1
Guinevere	0	0	0	1	0	1
Dog Park	0	0	0	1	0	1
Between the Folds	0	0	1	0	0	1
Delhi Belly	0	1	0	0	0	1
Upside Down: The Creation Records Story	0	0	1	0	0	1
Monte Carlo	0	0	1	0	0	1
One Day	0	1	0	0	0	1
Tears for Sale	0	1	0	0	0	1
Winnie the Pooh	0	0	1	0	0	1
Thumbelina	0	0	0	1	0	1
Denise Calls Up	1	0	0	0	0	1
Themroc	0	1	0	0	0	1
New One-Armed Swordsman, The (Xin du bi dao)	0	0	1	0	0	1
Mike's New Car	0	1	0	0	0	1
Paper Birds (Pájaros de papel)	1	0	0	0	0	1
Land and Freedom (Tierra y libertad)	0	1	0	0	0	1
Blitz	0	0	1	0	0	1
Yellow Sea, The (a.k.a. The Murderer) (Hwanghae)	0	0	1	0	0	1
Sugar Town	0	1	0	0	0	1
Dad's Army	0	0	0	1	0	1
Caligula	0	0	0	0	1	1
SUBWAYStories: Tales from the Underground	0	0	1	0	0	1
The Barkley Marathons: The Race That Eats Its Young	0	1	0	0	0	1
Merci Patron !	0	1	0	0	0	1
My Afternoons with Margueritte (La tête en friche)	0	0	1	0	0	1
Final Destination 5	1	0	0	0	0	1
I Saw What You Did	0	0	1	0	0	1
Soldier's Story, A	0	1	0	0	0	1
Thin Line Between Love and Hate, A	1	0	0	0	0	1
Othello (Tragedy of Othello: The Moor of Venice, The)	0	1	0	0	0	1
Falling Angels	0	1	0	0	0	1
Two Much	0	0	1	0	0	1
A German Life	0	0	1	0	0	1
Tag	0	1	0	0	0	1
Another Earth	1	0	0	0	0	1
Hesher	0	1	0	0	0	1
West Beirut (West Beyrouth)	0	1	0	0	0	1
Bedrooms & Hallways	0	0	1	0	0	1
Stake Land	0	1	0	0	0	1
Chill Factor	0	0	0	0	1	1
Debt, The	0	0	1	0	0	1
Fraktus	0	1	0	0	0	1
Bill Cunningham New York	1	0	0	0	0	1
Bread and Chocolate (Pane e cioccolata)	0	0	1	0	0	1
On the Ropes	1	0	0	0	0	1
Walled In	0	1	0	0	0	1
Hamlet	0	1	0	0	0	1
Birdemic: Shock and Terror	0	1	0	0	0	1
Camino	0	0	0	1	0	1
Love & Human Remains	0	0	0	0	1	1
Self-criticism of a Bourgeois Dog	0	0	1	0	0	1
Red State	0	0	1	0	0	1
Source, The	0	0	0	0	1	1
In Too Deep	0	0	1	0	0	1
Pearl Jam Twenty	0	0	0	0	1	1
I Don't Know How She Does It	0	0	0	1	0	1
Shark Night 3D	0	0	0	1	0	1
Neds	0	1	0	0	0	1
Noin 7 veljestä	0	0	1	0	0	1
Phineas and Ferb the Movie: Across the 2nd Dimension	0	1	0	0	0	1
Northanger Abbey	0	1	0	0	0	1
Florence Foster Jenkins	0	1	0	0	0	1
Oscar and Lucinda (a.k.a. Oscar & Lucinda)	1	0	0	0	0	1
Little Nemo: Adventures in Slumberland	0	0	1	0	0	1
Kill List	1	0	0	0	0	1
Bellflower	0	1	0	0	0	1
Generation P	0	1	0	0	0	1
My Big Fat Greek Wedding 2	0	0	0	1	0	1
BlinkyTM	0	0	1	0	0	1
Neon Bull	0	1	0	0	0	1
Three Outlaw Samurai (Sanbiki no samurai)	0	1	0	0	0	1
Antonio Gaudí	0	1	0	0	0	1
Reckoning, The	0	1	0	0	0	1
Lightning in a Bottle	0	1	0	0	0	1
Beautiful Boy	0	1	0	0	0	1
Tyrannosaur	0	1	0	0	0	1
Me Him Her	0	0	0	1	0	1
Behind Enemy Lines II: Axis of Evil	0	0	0	1	0	1
Great Day in Harlem, A	0	1	0	0	0	1
Der Herr Karl	0	0	1	0	0	1
Margaret	0	0	1	0	0	1
Head On	0	0	0	0	1	1
Better Than Chocolate	0	0	1	0	0	1
Love and a .45	0	1	0	0	0	1
Ice Age: The Great Egg-Scapade	1	0	0	0	0	1
Abduction	0	1	0	0	0	1
This Must Be the Place	0	1	0	0	0	1
Zoom	0	0	1	0	0	1
Acid House, The	0	1	0	0	0	1
What's Your Number?	1	0	0	0	0	1
Miss Representation	0	1	0	0	0	1
J. Edgar	0	0	1	0	0	1
Double, The	0	0	0	1	0	1
Starsuckers	0	1	0	0	0	1
Frances	0	1	0	0	0	1
Deadtime Stories	0	0	0	0	1	1
Tomboy	0	0	1	0	0	1
From the Hip	0	1	0	0	0	1
George Harrison: Living in the Material World	0	1	0	0	0	1
	1	0	0	0	0	1
Into the Abyss	1	0	0	0	0	1
Sign of Four, The	0	0	1	0	0	1
Project X	0	0	0	1	0	1
Lifted	0	1	0	0	0	1
Otello	0	1	0	0	0	1
Native Son	0	0	1	0	0	1
Ménage (Tenue de soirée)	0	0	0	0	1	1
The Trust	0	0	1	0	0	1
Kindred, The	0	0	0	0	1	1
Hipsters (Stilyagi)	0	1	0	0	0	1
Crimes of the Heart	0	1	0	0	0	1
Assassination	0	1	0	0	0	1
Another Cinderella Story	0	0	1	0	0	1
Bunraku	0	0	0	1	0	1
Jimmy Carr: Telling Jokes	0	1	0	0	0	1
Jimmy Carr: Making People Laugh	0	0	1	0	0	1
Play the Game	0	1	0	0	0	1
Texas - Doc Snyder hält die Welt in Atem	1	0	0	0	0	1
Asterix and the Vikings (Astérix et les Vikings)	1	0	0	0	0	1
Happy Feet Two	1	0	0	0	0	1
Arthur Christmas	0	0	0	0	1	1
Killer's Kiss	0	0	1	0	0	1
00 Schneider - Jagd auf Nihil Baxter	1	0	0	0	0	1
Twin Falls Idaho	0	0	0	1	0	1
Bullet to the Head	0	0	0	1	0	1
The Man Who Knew Infinity	0	0	1	0	0	1
Coriolanus	0	0	1	0	0	1
Despite the Falling Snow	0	0	0	1	0	1
Wizards of the Lost Kingdom II	0	0	0	0	1	1
Last Holiday	0	1	0	0	0	1
Undertow	0	0	1	0	0	1
Salvation Boulevard	0	0	0	1	0	1
Girl Walks Into a Bar	1	0	0	0	0	1
Dear Diary (Caro Diario)	0	1	0	0	0	1
Way South, The (De weg naar het zuiden)	0	1	0	0	0	1
Being Elmo: A Puppeteer's Journey	0	1	0	0	0	1
LEGO DC Super Hero Girls: Brain Drain	0	1	0	0	0	1
Joyful Noise	0	0	0	1	0	1
Iron Lady, The	0	0	1	0	0	1
Albatross	0	0	1	0	0	1
Revenant, The	1	0	0	0	0	1
Sacrifice (Zhao shi gu er)	0	0	1	0	0	1
Contact High	0	0	1	0	0	1
Zone 39	0	0	0	1	0	1
My Son the Fanatic	0	1	0	0	0	1
Ari Shaffir: Double Negative	0	1	0	0	0	1
Boys, The	0	0	0	1	0	1
Barbershop: The Next Cut	0	0	1	0	0	1
Einstein and Eddington	0	1	0	0	0	1
Apollo 18	0	0	0	1	0	1
The Nut Job 2: Nutty by Nature	0	0	0	1	0	1
Seeking Justice	0	0	0	1	0	1
Red Tails	0	0	0	1	0	1
Flowers of War, The (Jin líng shí san chai)	1	0	0	0	0	1
The Angry Birds Movie	0	0	1	0	0	1
Escort, The (Scorta, La)	0	0	1	0	0	1
Bliss	1	0	0	0	0	1
Alles Inklusive	0	1	0	0	0	1
Puss in Boots (Nagagutsu o haita neko)	0	1	0	0	0	1
Bakuman	0	1	0	0	0	1
I Am Wrath	0	0	0	1	0	1
Woman in Love (Rubbeldiekatz)	0	0	0	0	1	1
Precious Cargo	0	0	0	0	1	1
Ciao, Professore! (Io speriamo che me la cavo)	0	1	0	0	0	1
Tenchi Muyô! In Love	1	0	0	0	0	1
Dylan Moran: Monster	1	0	0	0	0	1
Earth vs. the Flying Saucers	0	0	0	0	1	1
Pitfall (Otoshiana)	0	1	0	0	0	1
Callas Forever	0	0	1	0	0	1
It Came from Outer Space	0	0	1	0	0	1
For a Good Time, Call...	0	0	1	0	0	1
It Came from Hollywood	0	0	0	1	0	1
Janie Jones	0	0	1	0	0	1
Tarantula	0	0	1	0	0	1
Howling II: Your Sister Is a Werewolf	0	0	0	1	0	1
Journey 2: The Mysterious Island	0	0	0	0	1	1
Curse of Frankenstein, The	0	0	1	0	0	1
Frankenstein Meets the Wolf Man	0	0	0	0	1	1
The Man Who Killed Don Quixote	1	0	0	0	0	1
Rollo and the Woods Sprite (Rölli ja metsänhenki)	0	0	0	1	0	1
Atomic Brain, The	0	1	0	0	0	1
Prayers for Bobby	0	1	0	0	0	1
Spring Forward	0	0	0	1	0	1
Very Potter Sequel, A	1	0	0	0	0	1
Miss Nobody	1	0	0	0	0	1
Germinal	0	1	0	0	0	1
Icarus	0	1	0	0	0	1
Saragossa Manuscript, The (Rekopis znaleziony w Saragossie)	0	1	0	0	0	1
Ratchet & Clank	0	0	0	1	0	1
Kicking Off	0	0	0	1	0	1
Civil War, The	0	1	0	0	0	1
SORI: Voice from the Heart	1	0	0	0	0	1
Gintama: The Final Chapter - Be Forever Yorozuya	0	1	0	0	0	1
Trippin'	0	0	0	0	1	1
Ro.Go.Pa.G.	0	0	1	0	0	1
This Is My Father	0	0	1	0	0	1
Women on the 6th Floor, The (Les Femmes du 6ème Étage)	0	1	0	0	0	1
Mega Shark vs. Crocosaurus	0	0	0	1	0	1
Red Hill	0	0	1	0	0	1
Mickey's The Prince and the Pauper	0	0	0	1	0	1
Kindergarten Cop 2	0	0	0	1	0	1
Gone	0	0	0	1	0	1
Mildred Pierce	0	1	0	0	0	1
Winslow Boy, The	0	0	1	0	0	1
King of Masks, The (Bian Lian)	0	1	0	0	0	1
Buck Rogers in the 25th Century	0	0	1	0	0	1
World of Glory	1	0	0	0	0	1
Trailer Park Boys	1	0	0	0	0	1
Ledge, The	0	0	1	0	0	1
Jeff, Who Lives at Home	0	1	0	0	0	1
Snowtown (Snowtown Murders, The)	0	0	1	0	0	1
The Crew	0	0	1	0	0	1
Space Battleship Yamato	0	0	1	0	0	1
The Forbidden Dance	0	0	1	0	0	1
Salmon Fishing in the Yemen	0	0	0	1	0	1
Hideous Kinky	0	0	1	0	0	1
Friends & Lovers	0	1	0	0	0	1
Detachment	0	1	0	0	0	1
The Shallows	0	0	1	0	0	1
The Wild One	0	1	0	0	0	1
Gen-X Cops	0	1	0	0	0	1
Cage Dive	0	0	0	0	1	1
Absentia	0	1	0	0	0	1
God Bless America	1	0	0	0	0	1
The BFG	0	0	1	0	0	1
Metroland	0	0	1	0	0	1
Raven, The	0	0	0	1	0	1
North & South	1	0	0	0	0	1
Tango	0	0	0	0	1	1
Big Bang, The	0	0	0	1	0	1
Comic-Con Episode IV: A Fan's Hope	0	0	0	1	0	1
My Scientology Movie	0	1	0	0	0	1
Karate Bullfighter	0	0	1	0	0	1
Dante's Inferno: An Animated Epic	0	0	1	0	0	1
All Yours	1	0	0	0	0	1
Atomic Submarine, The	0	0	1	0	0	1
Silver Spoon	0	1	0	0	0	1
Guerrilla: The Taking of Patty Hearst	0	1	0	0	0	1
Lucky One, The	0	1	0	0	0	1
King and I, The	0	0	1	0	0	1
The Wailing	0	0	1	0	0	1
I Stand Alone (Seul contre tous)	1	0	0	0	0	1
	1	0	0	0	0	1
Boniface's Holiday	0	0	0	1	0	1
96 Minutes	0	0	1	0	0	1
Comedy of the Strict Regime	1	0	0	0	0	1
Rocket Singh: Salesman of the Year	0	1	0	0	0	1
Walking with Monsters	0	1	0	0	0	1
Sound of My Voice	0	1	0	0	0	1
Eva	1	0	0	0	0	1
The Meddler	0	0	1	0	0	1
School of Flesh, The (École de la chair, L')	0	0	1	0	0	1
Pact, The	0	1	0	0	0	1
Boundaries	0	0	1	0	0	1
Ali Wong: Baby Cobra	1	0	0	0	0	1
Inhale	0	0	1	0	0	1
Dancemaker	0	0	0	0	1	1
Little Boxes	0	1	0	0	0	1
Geostorm	0	0	0	1	0	1
Maz Jobrani: Immigrant	1	0	0	0	0	1
Take This Waltz	0	1	0	0	0	1
Superman/Doomsday	0	1	0	0	0	1
Your Sister's Sister	0	1	0	0	0	1
Dragon Ball: The Curse Of The Blood Rubies (Doragon bôru: Shenron no densetsu)	0	1	0	0	0	1
Café Society	0	0	1	0	0	1
Superman/Batman: Public Enemies	1	0	0	0	0	1
Dragon Ball: Mystical Adventure (Doragon bôru: Makafushigi dai bôken)	0	1	0	0	0	1
Sword Art Online The Movie: Ordinal Scale	0	0	1	0	0	1
The Night Is Short, Walk on Girl	1	0	0	0	0	1
Dragon Ball Z the Movie: The World's Strongest (a.k.a. Dragon Ball Z: The Strongest Guy in The World) (Doragon bôru Z: Kono yo de ichiban tsuyoi yatsu)	0	1	0	0	0	1
Neo Tokyo	0	0	1	0	0	1
Beauty and the Beast: The Enchanted Christmas	0	1	0	0	0	1
Bush's Brain	0	0	1	0	0	1
Fireworks, Should We See It from the Side or the Bottom?	0	0	0	1	0	1
Front of the Class	1	0	0	0	0	1
Damn Yankees!	0	1	0	0	0	1
Children of the Corn III	0	0	0	0	1	1
Death Smiles on a Murderer	0	0	0	1	0	1
Love Live! The School Idol Movie	0	1	0	0	0	1
Pocahontas II: Journey to a New World	0	0	0	1	0	1
Ballad of Narayama, The (Narayama bushiko)	1	0	0	0	0	1
Adventures in Plymptoons!	0	1	0	0	0	1
What to Expect When You're Expecting	0	0	1	0	0	1
To Rome with Love	0	0	1	0	0	1
First Position	0	1	0	0	0	1
Apple, The (Sib)	0	1	0	0	0	1
Presto	1	0	0	0	0	1
Jack-Jack Attack	1	0	0	0	0	1
Dragon Ball Z: The Return of Cooler (Doragon bôru Z 6: Gekitotsu! Hyakuoku pawâ no senshi)	0	1	0	0	0	1
Spiral	0	0	1	0	0	1
Teenage Mutant Ninja Turtles: Out of the Shadows	0	0	0	1	0	1
Dragon Ball Z: Broly - The Legendary Super Saiyan (Doragon bôru Z 8: Moetsukiro!! Nessen retsusen-chô gekisen)	0	1	0	0	0	1
Gaga: Five Foot Two	0	1	0	0	0	1
Savage Nights (Nuits fauves, Les)	0	1	0	0	0	1
Harmonists, The	0	1	0	0	0	1
Cleanskin	0	1	0	0	0	1
Dragon Ball Z: Bojack Unbound (Doragon bôru Z 9: Ginga girigiri!! Butchigiri no sugoi yatsu)	0	1	0	0	0	1
Show Boat	0	0	1	0	0	1
Dave Chappelle: Killin' Them Softly	0	1	0	0	0	1
Firm, The	0	0	1	0	0	1
Day of the Beast, The (Día de la Bestia, El)	0	1	0	0	0	1
Godzilla vs. Mechagodzilla (Gojira tai Mekagojira)	0	0	1	0	0	1
My Name Is Joe	0	1	0	0	0	1
Spirit Camp	1	0	0	0	0	1
Animal Factory	0	0	1	0	0	1
Some Guy Who Kills People	1	0	0	0	0	1
Front Cover	0	1	0	0	0	1
Treasure Island	0	0	0	1	0	1
Adventures of Mary-Kate and Ashley, The: The Case of the Christmas Caper	0	0	1	0	0	1
Cincinnati Kid, The	0	0	0	0	1	1
2 Days in New York	0	0	1	0	0	1
Killer Joe	1	0	0	0	0	1
Dragon Ball Z: Broly Second Coming (Doragon bôru Z 10: Kiken na futari! Sûpâ senshi wa nemurenai)	0	1	0	0	0	1
Dragon Ball Z: Bio-Broly (Doragon bôru Z 11: Sûpâ senshi gekiha! Katsu no wa ore da)	0	1	0	0	0	1
Anaconda: The Offspring	0	0	0	0	1	1
Amateur	0	0	0	1	0	1
Christmas Carol, A	0	0	1	0	0	1
Texas Chainsaw Massacre: The Next Generation (a.k.a. The Return of the Texas Chainsaw Massacre)	0	0	1	0	0	1
Awfully Big Adventure, An	1	0	0	0	0	1
Goodbye Charlie	1	0	0	0	0	1
Angels' Share, The	0	1	0	0	0	1
Immature, The (Immaturi)	0	1	0	0	0	1
Dragon Ball Z: Bardock - The Father of Goku (Doragon bôru Z: Tatta hitori no saishuu kessen - Furiiza ni itonda Z senshi Kakarotto no chichi)	0	1	0	0	0	1
King of Hearts	1	0	0	0	0	1
Dragon Ball GT: A Hero's Legacy (Doragon bôru GT: Gokû gaiden! Yûki no akashi wa sû-shin-chû)	0	0	0	1	0	1
2048: Nowhere to Run	0	1	0	0	0	1
Gate, The	0	0	1	0	0	1
Hands Over the City (Le mani sulla città)	1	0	0	0	0	1
Jon Stewart Has Left the Building	0	1	0	0	0	1
Brake	0	0	0	1	0	1
Follow Me, Boys!	0	0	0	0	1	1
Hope Springs	0	0	0	0	1	1
Queen of Versailles, The	0	0	0	1	0	1
Male Hunt	0	0	1	0	0	1
The Death of Stalin	0	1	0	0	0	1
Confidential Report	0	1	0	0	0	1
Hurlyburly	0	1	0	0	0	1
Diary of a Wimpy Kid: Dog Days	0	0	1	0	0	1
Broken	1	0	0	0	0	1
6 Days to Air: The Making of South Park	0	1	0	0	0	1
Odd Life of Timothy Green, The	1	0	0	0	0	1
Prime Suspect 3	0	0	1	0	0	1
Prime Suspect 6: The Last Witness	0	0	1	0	0	1
Prime Suspect: The Lost Child	0	0	0	1	0	1
Marauders	0	1	0	0	0	1
Conception	0	0	1	0	0	1
Paradise Lost 3: Purgatory	0	1	0	0	0	1
Words, The	0	1	0	0	0	1
Runaway Brain	1	0	0	0	0	1
Human Condition I, The (Ningen no joken I)	1	0	0	0	0	1
King Solomon's Mines	0	0	1	0	0	1
Lola Versus	0	0	0	1	0	1
Heartburn	0	0	0	0	1	1
Northwest Passage	0	0	1	0	0	1
Violets Are Blue...	0	0	1	0	0	1
Holy Motors	1	0	0	0	0	1
House at the End of the Street	0	1	0	0	0	1
My Left Eye Sees Ghosts (Ngo joh aan gin diy gwai)	1	0	0	0	0	1
Love Lasts Three Years (L'amour dure trois ans)	0	1	0	0	0	1
Tall Man, The	0	0	0	1	0	1
LOL	0	1	0	0	0	1
Rust and Bone (De rouille et d'os)	0	0	0	0	1	1
Advise and Consent	1	0	0	0	0	1
Johnny Eager	0	1	0	0	0	1
Sinister	0	1	0	0	0	1
Thing: Terror Takes Shape, The	0	0	0	0	1	1
Side by Side	0	0	1	0	0	1
Take Aim at the Police Van (Sono gosôsha wo nerae: 'Jûsangô taihisen' yori)	0	1	0	0	0	1
Liberal Arts	0	0	1	0	0	1
Immigrant, The	1	0	0	0	0	1
Johnny Belinda	0	1	0	0	0	1
Executive Suite	0	0	1	0	0	1
Asterix & Obelix: God Save Britannia (Astérix et Obélix: Au service de Sa Majesté)	0	0	1	0	0	1
Paranormal Activity 4	0	0	1	0	0	1
Alex Cross	0	0	0	1	0	1
'Hellboy': The Seeds of Creation	0	1	0	0	0	1
Silent Hill: Revelation 3D	0	0	1	0	0	1
Mental	0	0	0	1	0	1
Dragon Seed	0	1	0	0	0	1
Sessions, The (Surrogate, The)	0	1	0	0	0	1
Steam: The Turkish Bath (Hamam)	0	1	0	0	0	1
Smashed	0	1	0	0	0	1
Loving Vincent	1	0	0	0	0	1
Anna Karenina	0	0	1	0	0	1
Man with the Iron Fists, The	0	0	1	0	0	1
Bay, The	0	0	1	0	0	1
Himizu	0	1	0	0	0	1
Heiress, The	0	1	0	0	0	1
To Each His Own	0	1	0	0	0	1
Nature Calls	0	0	0	1	0	1
Vamps	0	0	0	1	0	1
10 Years	0	1	0	0	0	1
Investigation of a Citizen Above Suspicion (Indagine su un cittadino al di sopra di ogni sospetto)	0	1	0	0	0	1
Luna Papa	0	1	0	0	0	1
Deadfall	0	0	0	1	0	1
Byzantium	0	1	0	0	0	1
Herod's Law (Ley de Herodes, La)	0	0	1	0	0	1
Emerald Forest, The	0	0	1	0	0	1
Half a Loaf of Kung Fu (Dian zhi gong fu gan chian chan)	0	0	1	0	0	1
King Kong Lives	0	0	0	1	0	1
From Up on Poppy Hill (Kokuriko-zaka kara)	1	0	0	0	0	1
Redline	1	0	0	0	0	1
Anthony Adverse	0	0	1	0	0	1
This Island Earth	0	0	0	0	1	1
Blue Planet II	1	0	0	0	0	1
Glen or Glenda	0	1	0	0	0	1
Sands of Iwo Jima	0	0	1	0	0	1
My Lucky Stars (Fuk sing go jiu)	0	1	0	0	0	1
Money Money Money (L'aventure, c'est l'aventure)	0	0	1	0	0	1
Savior	0	1	0	0	0	1
Liar's Autobiography: The Untrue Story of Monty Python's Graham Chapman, A	0	0	1	0	0	1
Hyde Park on Hudson	0	0	0	1	0	1
How to Make Love to a Woman	0	0	0	1	0	1
Fire with Fire	0	0	0	1	0	1
Wrong	0	1	0	0	0	1
Playing for Keeps	0	0	1	0	0	1
I Bought a Vampire Motorcycle	0	1	0	0	0	1
Americathon	0	0	0	1	0	1
Ice Cream Man	0	1	0	0	0	1
Campfire Tales	0	1	0	0	0	1
Man of the Year	0	0	1	0	0	1
Parental Guidance	0	0	0	1	0	1
Robot Carnival (Roboto kânibauru)	0	1	0	0	0	1
Meet the Applegates	0	0	0	1	0	1
Divorcee, The	0	1	0	0	0	1
I'll Be Home For Christmas	0	0	0	1	0	1
Promised Land	0	0	1	0	0	1
English Vinglish	1	0	0	0	0	1
Fish Story (Fisshu sutôrî)	0	0	1	0	0	1
Texas Chainsaw 3D	0	0	0	1	0	1
Iceman, The	0	1	0	0	0	1
Suddenly	0	1	0	0	0	1
Night and Fog (Nuit et brouillard)	1	0	0	0	0	1
Book of Love	0	0	0	1	0	1
Big Wednesday	0	0	1	0	0	1
Everything or Nothing: The Untold Story of 007	0	0	1	0	0	1
Codependent Lesbian Space Alien Seeks Same	0	1	0	0	0	1
Dane Cook: Troublemaker	0	1	0	0	0	1
Silent Movie	0	1	0	0	0	1
Shadow Dancer	0	0	1	0	0	1
Lover Come Back	0	0	1	0	0	1
Human Planet	0	1	0	0	0	1
Comme un chef	0	1	0	0	0	1
Pervert's Guide to Ideology, The	0	1	0	0	0	1
Sightseers	1	0	0	0	0	1
Jim Jefferies: Fully Functional (EPIX)	1	0	0	0	0	1
Why Stop Now	0	0	0	1	0	1
Hope Springs	0	0	0	0	1	1
Tabu	0	1	0	0	0	1
Upside Down	0	0	1	0	0	1
Liability, The	0	0	1	0	0	1
Pie in the Sky	0	0	0	1	0	1
One Tough Cop	0	0	1	0	0	1
Angst 	0	1	0	0	0	1
Love Is the Devil	0	1	0	0	0	1
Stand Up Guys	0	0	1	0	0	1
ABCs of Death, The	0	1	0	0	0	1
Beautiful Creatures	0	0	0	1	0	1
Safe Haven	0	1	0	0	0	1
Strangeland	0	1	0	0	0	1
Hello Again	0	0	1	0	0	1
Act of Killing, The	1	0	0	0	0	1
Father Hood	0	0	1	0	0	1
Universal Soldier: Day of Reckoning	0	1	0	0	0	1
Overnight Delivery	0	0	1	0	0	1
Dresser, The	0	0	1	0	0	1
Snitch	0	1	0	0	0	1
Doctor, The	0	1	0	0	0	1
Oh Boy (A Coffee in Berlin)	0	1	0	0	0	1
Anna Christie	0	1	0	0	0	1
Fiendish Plot of Dr. Fu Manchu, The	0	0	0	1	0	1
Hunting of the President, The	0	0	1	0	0	1
Maniac Cop 2	1	0	0	0	0	1
Monument Ave.	0	0	1	0	0	1
Allegro non troppo	0	1	0	0	0	1
Wadjda	0	0	1	0	0	1
Unintentional Kidnapping of Mrs. Elfriede Ott, The (Die Unabsichtliche Entführung der Frau Elfriede Ott)	0	0	1	0	0	1
Legend of Sleepy Hollow, The	0	0	0	1	0	1
That's Entertainment	0	1	0	0	0	1
Door in the Floor, The	0	0	1	0	0	1
Two Brothers (Deux frères)	0	1	0	0	0	1
Call, The	0	0	0	1	0	1
Thief of Bagdad, The	0	1	0	0	0	1
De-Lovely	0	1	0	0	0	1
Mezzo Forte	0	0	1	0	0	1
Brass Teapot, The	0	0	0	1	0	1
Phil Spector	0	0	0	1	0	1
Bob & Carol & Ted & Alice	0	1	0	0	0	1
What Happened Was...	1	0	0	0	0	1
D.A.R.Y.L.	0	0	0	1	0	1
Happenstance (Battement d'ailes du papillon, Le)	0	0	1	0	0	1
Dark Tide	0	0	0	1	0	1
No Small Affair	0	1	0	0	0	1
Comandante	0	1	0	0	0	1
In the Realm of the Senses (Ai no corrida)	1	0	0	0	0	1
42	0	1	0	0	0	1
Disconnect	0	0	0	1	0	1
Invincible Iron Man, The	0	0	1	0	0	1
Yongary: Monster from the Deep	0	0	0	0	1	1
Hulk Vs.	0	0	1	0	0	1
Resolution	0	1	0	0	0	1
A Midsummer Night's Dream	0	1	0	0	0	1
Grabbers	0	0	1	0	0	1
Justice League: Doom	1	0	0	0	0	1
Grandmaster, The (Yi dai zong shi)	0	0	0	1	0	1
English Teacher, The	0	0	0	1	0	1
Bill Hicks: Revelations	1	0	0	0	0	1
Pawn	0	0	0	1	0	1
Shaolin Temple (Shao Lin si)	1	0	0	0	0	1
Jupiter's Wife	0	0	1	0	0	1
Ring, The	0	0	0	0	1	1
Mayhem	0	0	0	0	1	1
Secret Agent	0	0	1	0	0	1
Into the Woods	1	0	0	0	0	1
Black Narcissus	0	1	0	0	0	1
Jamaica Inn	0	0	1	0	0	1
Darkon	0	0	1	0	0	1
Mimino	0	1	0	0	0	1
Ivan Vasilievich: Back to the Future (Ivan Vasilievich menyaet professiyu)	1	0	0	0	0	1
Teacher's Pet	0	1	0	0	0	1
Major and the Minor, The	0	1	0	0	0	1
Make Way for Tomorrow	0	1	0	0	0	1
Knock Off	1	0	0	0	0	1
Captain America	0	0	0	0	1	1
Tie Xi Qu: West of the Tracks (Tiexi qu)	0	1	0	0	0	1
Rink, The	0	1	0	0	0	1
Why Do Fools Fall In Love?	0	0	0	1	0	1
Captain America II: Death Too Soon	0	0	0	0	1	1
Man Who Came to Dinner, The	0	1	0	0	0	1
Down Terrace	0	1	0	0	0	1
Invisible Man Returns, The	0	0	1	0	0	1
Frances Ha	0	0	1	0	0	1
Lords of Salem, The	0	0	1	0	0	1
Behind the Candelabra	0	0	1	0	0	1
As I Was Moving Ahead Occasionally I Saw Brief Glimpses of Beauty	0	1	0	0	0	1
Torn Curtain	0	1	0	0	0	1
Topaz	0	0	1	0	0	1
Front Page, The	0	1	0	0	0	1
Emerald Green	0	1	0	0	0	1
With Great Power: The Stan Lee Story	0	0	1	0	0	1
Déjà Vu	1	0	0	0	0	1
Used People	0	1	0	0	0	1
Strike! (a.k.a. All I Wanna Do, The Hairy Bird)	0	0	1	0	0	1
Inhuman Resources (Redd Inc.)	1	0	0	0	0	1
Much Ado About Nothing	0	0	1	0	0	1
Best Defense	0	0	1	0	0	1
Rapture-Palooza	0	0	1	0	0	1
College	0	1	0	0	0	1
Hunchback of Notre Dame, The	0	0	1	0	0	1
Surf Nazis Must Die	0	0	0	0	1	1
Hip Hop Witch, Da	0	0	0	0	1	1
Schlussmacher	0	0	0	0	1	1
Fullmetal Alchemist: The Sacred Star of Milos	0	0	0	1	0	1
Maniac	0	1	0	0	0	1
Not Suitable for Children	0	0	1	0	0	1
Best Man, The (Testimone dello sposo, Il)	0	1	0	0	0	1
LEGO Batman: The Movie - DC Heroes Unite	0	0	1	0	0	1
Lost Skeleton of Cadavra, The	0	1	0	0	0	1
Adam and Eve (National Lampoon's Adam & Eve)	0	0	1	0	0	1
Wonder Wheel	0	0	1	0	0	1
Redemption (Hummingbird)	0	0	0	1	0	1
Passion	0	0	0	0	1	1
V/H/S/2	1	0	0	0	0	1
Knot, The	0	0	0	1	0	1
Creep 2	0	0	0	1	0	1
Grey Gardens	0	1	0	0	0	1
Human Condition II, The (Ningen no joken II)	1	0	0	0	0	1
Craig Ferguson: I'm Here To Help	1	0	0	0	0	1
Stuck in Love	0	1	0	0	0	1
Class Act	0	0	0	1	0	1
Mayor of the Sunset Strip	0	1	0	0	0	1
Field in England, A	1	0	0	0	0	1
Turbo	0	0	1	0	0	1
Killing Me Softly	0	1	0	0	0	1
Revenge for Jolly!	0	0	0	1	0	1
3 dev adam (Three Giant Men)	0	0	0	0	1	1
Masterminds	0	1	0	0	0	1
Alan Partridge: Alpha Papa	0	1	0	0	0	1
Viridiana	0	1	0	0	0	1
Batman: Mystery of the Batwoman	0	0	1	0	0	1
Little Murders	1	0	0	0	0	1
While the City Sleeps	0	0	0	0	1	1
Lee Daniels' The Butler	0	0	0	1	0	1
An Amazing Couple	0	1	0	0	0	1
I Love You Again	0	1	0	0	0	1
Philadelphia Experiment, The	0	1	0	0	0	1
Maria Bamford: The Special Special Special!	0	0	0	0	1	1
Getaway	0	0	0	0	1	1
Mystery of the Third Planet, The (Tayna tretey planety)	1	0	0	0	0	1
Night of the Living Dead	0	1	0	0	0	1
Rage of Honor	0	0	0	1	0	1
Juice	0	1	0	0	0	1
Freshman, The	0	1	0	0	0	1
Hiroshima Mon Amour	0	1	0	0	0	1
Collision Course	0	0	0	1	0	1
Inescapable	0	0	0	0	1	1
Beyond the Valley of the Dolls	0	1	0	0	0	1
Mood Indigo (L'écume des jours)	0	1	0	0	0	1
Catch That Kid	0	0	0	1	0	1
Anne of the Thousand Days	0	1	0	0	0	1
Americanization of Emily, The	0	1	0	0	0	1
Bad Milo (Bad Milo!)	0	0	0	0	1	1
Zazie dans le métro	0	0	1	0	0	1
Tex	0	1	0	0	0	1
Sansho the Bailiff (Sanshô dayû)	0	1	0	0	0	1
Young Poisoner's Handbook, The	0	0	1	0	0	1
The Bremen Town Musicians	1	0	0	0	0	1
Collector, The	0	0	0	0	1	1
Latter Days	0	1	0	0	0	1
All Dogs Christmas Carol, An	1	0	0	0	0	1
Rush	0	1	0	0	0	1
LBJ	0	1	0	0	0	1
Greed	0	1	0	0	0	1
Thief of Paris, The (Le voleur)	0	0	1	0	0	1
Zero de conduite (Zero for Conduct) (Zéro de conduite: Jeunes diables au collège)	0	1	0	0	0	1
UnHung Hero	1	0	0	0	0	1
Counselor, The	0	0	0	1	0	1
Escape From Tomorrow	0	0	1	0	0	1
Double, The	0	1	0	0	0	1
Lust for Life	0	0	1	0	0	1
Selfish Giant, The	0	1	0	0	0	1
Charly	0	1	0	0	0	1
Lola Montès	0	1	0	0	0	1
Book Thief, The	0	0	1	0	0	1
Charlie Countryman	0	0	0	1	0	1
Red Flag	1	0	0	0	0	1
Guilty of Romance (Koi no tsumi)	0	0	1	0	0	1
Homefront	0	0	1	0	0	1
Jazz Singer, The	0	1	0	0	0	1
Mephisto	1	0	0	0	0	1
Black Butler: Book of the Atlantic	0	1	0	0	0	1
All is Bright	0	0	0	1	0	1
Tim's Vermeer	0	1	0	0	0	1
Steamboat Bill, Jr.	1	0	0	0	0	1
RoboGeisha (Robo-geisha)	0	0	1	0	0	1
Wasp Woman, The	0	0	0	0	1	1
Indestructible Man	0	0	0	0	1	1
Christmas Carol, A	0	0	0	0	1	1
Little Caesar	0	1	0	0	0	1
Zatoichi and the Chest of Gold (Zatôichi senryô-kubi) (Zatôichi 6)	0	1	0	0	0	1
Pursuit of Happiness	0	1	0	0	0	1
Dampfnudelblues	0	0	1	0	0	1
Only Old Men Are Going to Battle (V boy idut odni stariki)	1	0	0	0	0	1
Guest from the Future (Gostya iz buduschego)	0	1	0	0	0	1
Kidnapping, Caucasian Style (Kavkazskaya plennitsa)	1	0	0	0	0	1
In Search of the Castaways	0	0	1	0	0	1
Hot Lead and Cold Feet	0	0	1	0	0	1
Haunter	0	0	1	0	0	1
Wrong Cops	0	1	0	0	0	1
Muppet Christmas: Letters to Santa, A	0	0	0	1	0	1
Roman J. Israel, Esq.	0	0	0	1	0	1
Ninja: Shadow of a Tear	1	0	0	0	0	1
Boudu Saved From Drowning (Boudu sauvé des eaux)	0	0	0	0	1	1
High School	1	0	0	0	0	1
Shock Corridor	0	1	0	0	0	1
Sunrise: A Song of Two Humans	0	1	0	0	0	1
Highlander: The Search for Vengeance	0	0	1	0	0	1
A Bad Moms Christmas	0	1	0	0	0	1
Only Lovers Left Alive	1	0	0	0	0	1
Molly's Game	0	1	0	0	0	1
Candleshoe	0	1	0	0	0	1
Cats	0	1	0	0	0	1
Catwalk	0	1	0	0	0	1
MacGyver: Trail to Doomsday	0	1	0	0	0	1
Bad Karma	0	0	0	1	0	1
Barefoot Executive, The	0	0	0	1	0	1
Hunting Elephants	1	0	0	0	0	1
Beyond the Clouds (Al di là delle nuvole)	0	0	1	0	0	1
Daddy's Home 2	0	1	0	0	0	1
Freezer	0	0	0	1	0	1
Nobody Loves Me (Keiner liebt mich)	0	1	0	0	0	1
Bo Burnham: Make Happy	0	0	1	0	0	1
Dragon ball Z 04: Lord Slug	0	1	0	0	0	1
Chinese Puzzle (Casse-tête chinois)	1	0	0	0	0	1
Dragon Ball: The Path to Power (Doragon bôru: Saikyô e no michi)	0	1	0	0	0	1
Delta Force 2 (Delta Force 2: The Colombian Connection)	0	1	0	0	0	1
Hotel Chevalier (Part 1 of 'The Darjeeling Limited')	0	1	0	0	0	1
Ernest & Célestine (Ernest et Célestine)	1	0	0	0	0	1
Drift	0	0	0	1	0	1
In China They Eat Dogs (I Kina spiser de hunde)	0	1	0	0	0	1
Better Living Through Chemistry	0	0	0	1	0	1
Bad Day at Black Rock	0	1	0	0	0	1
Wonder Woman	1	0	0	0	0	1
Nymphomaniac: Volume II	1	0	0	0	0	1
Shiri (Swiri)	0	1	0	0	0	1
Venus in Fur (La Vénus à la fourrure)	1	0	0	0	0	1
This World, Then the Fireworks	0	0	1	0	0	1
Frankenstein Unbound	0	0	1	0	0	1
Date and Switch	0	0	0	1	0	1
Winter's Tale	0	0	0	1	0	1
On the Other Side of the Tracks (De l'autre côté du périph)	1	0	0	0	0	1
GLOW: The Story of the Gorgeous Ladies of Wrestling	0	0	1	0	0	1
Cold Comes the Night	0	0	0	1	0	1
Chouchou	0	1	0	0	0	1
Someone Marry Barry	0	0	1	0	0	1
Sweet Bird of Youth	0	0	1	0	0	1
Oversimplification of Her Beauty, An	0	1	0	0	0	1
Bring It On: Fight to the Finish	0	0	0	1	0	1
Hamburger Hill	0	0	0	1	0	1
Where the Day Takes You	0	1	0	0	0	1
Wrinkles (Arrugas)	0	1	0	0	0	1
Garden of Words, The (Koto no ha no niwa)	1	0	0	0	0	1
Particle Fever	1	0	0	0	0	1
Bag Man, The	0	1	0	0	0	1
Prom Night IV: Deliver Us From Evil	0	1	0	0	0	1
Jack the Bear	0	0	0	1	0	1
Suriyothai (a.k.a. Legend of Suriyothai, The)	0	1	0	0	0	1
Halloween 4: The Return of Michael Myers	0	0	0	1	0	1
The Shining	0	0	0	1	0	1
Dinner at Eight	0	1	0	0	0	1
Pelé: Birth of a Legend	1	0	0	0	0	1
Jim & Andy: The Great Beyond	1	0	0	0	0	1
Friday the 13th Part VII: The New Blood	0	0	0	1	0	1
The Thief	1	0	0	0	0	1
Tormented	0	0	0	0	1	1
Dark Water (Honogurai mizu no soko kara)	0	1	0	0	0	1
Son of God	0	0	0	0	1	1
Puss in Boots: The Three Diablos	0	0	1	0	0	1
Intolerance: Love's Struggle Throughout the Ages	0	1	0	0	0	1
Ocho apellidos vascos	1	0	0	0	0	1
King of Comedy (Hei kek ji wong)	0	1	0	0	0	1
13 Sins	0	1	0	0	0	1
Me and you (io e te)	1	0	0	0	0	1
Free to Play	1	0	0	0	0	1
Unknown Known, The	0	1	0	0	0	1
Brain Smasher... A Love Story (Bouncer and the Lady, The)	0	0	1	0	0	1
Calvary	0	1	0	0	0	1
Oculus	1	0	0	0	0	1
God's Not Dead	0	0	0	0	1	1
Cold in July	0	0	1	0	0	1
Phantom Tollbooth, The	0	1	0	0	0	1
Farmer's Daughter, The	0	1	0	0	0	1
Fading Gigolo	0	1	0	0	0	1
Hatchet III	0	1	0	0	0	1
Haunted House 2, A	0	0	0	0	1	1
Mulan II	0	0	1	0	0	1
Brick Mansions	0	0	0	1	0	1
Alpha and Omega 3: The Great Wolf Games	1	0	0	0	0	1
Mom's Night Out	0	0	0	1	0	1
Walk of Shame	0	0	1	0	0	1
Blue Ruin	0	1	0	0	0	1
O.J.: Made in America	1	0	0	0	0	1
Afflicted	0	1	0	0	0	1
Butterfield 8	0	0	1	0	0	1
At Middleton	0	0	0	1	0	1
Dance of Reality, The (Danza de la realidad, La)	0	1	0	0	0	1
No Game No Life: Zero	0	1	0	0	0	1
Midnight Chronicles	0	0	0	0	1	1
Million Dollar Arm	0	0	1	0	0	1
G.B.F.	0	0	1	0	0	1
Power of One, The	0	1	0	0	0	1
Gentleman's Agreement	0	1	0	0	0	1
Jimi: All Is by My Side	0	1	0	0	0	1
Bloodmoon	0	0	1	0	0	1
Bucket Of Blood, A	0	0	1	0	0	1
Genius	0	0	1	0	0	1
Die Frauen von Ravensbrück	1	0	0	0	0	1
Life of Emile Zola, The	0	0	1	0	0	1
Great Ziegfeld, The	0	1	0	0	0	1
Bad Asses (Bad Ass 2)	0	1	0	0	0	1
Space Truckers	0	0	0	1	0	1
Cimarron	0	1	0	0	0	1
Lilting	1	0	0	0	0	1
Broadway Melody, The	0	0	1	0	0	1
Maps to the Stars	0	1	0	0	0	1
Think Like a Man Too	0	0	0	1	0	1
Dolls	0	0	1	0	0	1
Jersey Boys	0	0	1	0	0	1
Nick Fury: Agent of S.H.I.E.L.D.	0	0	0	0	1	1
Internet's Own Boy: The Story of Aaron Swartz, The	1	0	0	0	0	1
They Came Together	0	0	0	1	0	1
Honey (Miele)	0	1	0	0	0	1
Robot Jox	0	0	0	0	1	1
From Beyond	0	1	0	0	0	1
Ashes and Diamonds (Popiól i diament)	0	1	0	0	0	1
Colourful (Karafuru)	1	0	0	0	0	1
Angriest Man in Brooklyn, The	0	1	0	0	0	1
Dr. Terror's House of Horrors	0	0	0	1	0	1
Deliver Us from Evil	0	0	1	0	0	1
And So It Goes	0	0	0	1	0	1
Secret Society	0	0	0	0	1	1
Ferdinand	0	0	0	1	0	1
Dream for an Insomniac	0	1	0	0	0	1
Children of Heaven, The (Bacheha-Ye Aseman)	0	1	0	0	0	1
Long Day's Journey Into Night	0	1	0	0	0	1
Signal, The	1	0	0	0	0	1
A Most Wanted Man	1	0	0	0	0	1
Beyond Silence (Jenseits der Stille)	1	0	0	0	0	1
Life After Beth	0	1	0	0	0	1
Ugly, The	0	0	0	1	0	1
Felony	0	0	1	0	0	1
In the Bleak Midwinter	0	1	0	0	0	1
Monterey Pop	0	1	0	0	0	1
Get on Up	0	1	0	0	0	1
Magic in the Moonlight	0	0	1	0	0	1
Ken Park	1	0	0	0	0	1
The Hundred-Foot Journey	1	0	0	0	0	1
Nightbreed	0	0	0	1	0	1
Batman: Assault on Arkham	0	0	1	0	0	1
White Frog	0	1	0	0	0	1
Den, The	0	1	0	0	0	1
Dancer, Texas Pop. 81	0	0	1	0	0	1
Tarzan and the Lost City	0	0	0	1	0	1
Night of the Iguana, The	0	0	1	0	0	1
I'll Follow You Down	0	0	0	1	0	1
Old Lady and the Pigeons, The (La vieille dame et les pigeons)	0	0	1	0	0	1
Pretty One, The	0	1	0	0	0	1
Killers, The	0	1	0	0	0	1
Revenge of the Green Dragons	0	0	0	1	0	1
Real Blonde, The	0	1	0	0	0	1
Lynne Koplitz: Hormonal Beast	0	0	0	1	0	1
The Magician	1	0	0	0	0	1
Sacrament, The	0	1	0	0	0	1
If I Stay	0	0	0	1	0	1
Two Days, One Night (Deux jours, une nuit)	0	1	0	0	0	1
Gingerbread Man, The	0	0	1	0	0	1
Through a Glass Darkly (Såsom i en spegel)	1	0	0	0	0	1
My Giant	0	0	1	0	0	1
As Above, So Below	0	0	1	0	0	1
Phantom Thread	0	1	0	0	0	1
One I Love, The	1	0	0	0	0	1
Headshot	0	0	1	0	0	1
Guest, The	0	1	0	0	0	1
Winter Light (Nattvardsgästerna)	0	1	0	0	0	1
The Adderall Diaries	0	0	0	1	0	1
Too Funny to Fail: The Life and Death of The Dana Carvey Show	1	0	0	0	0	1
Barney's Great Adventure	0	0	0	1	0	1
The Players Club	0	1	0	0	0	1
Homegrown	0	0	0	0	1	1
Honeymoon	0	1	0	0	0	1
Craig Ferguson: Tickle Fight	0	0	1	0	0	1
Serving in Silence: The Margarethe Cammermeyer Story	0	1	0	0	0	1
20,000 Days on Earth	0	1	0	0	0	1
Beautiful Losers	0	0	1	0	0	1
Cool, Dry Place, A	0	0	1	0	0	1
Camp X-Ray	0	1	0	0	0	1
Walk Among the Tombstones, A	0	0	1	0	0	1
Hare-um Scare-um	0	1	0	0	0	1
Laggies	1	0	0	0	0	1
La cravate	0	0	1	0	0	1
Shame (Skammen)	0	1	0	0	0	1
Cesar Chavez	0	0	0	1	0	1
Love and Death on Long Island	0	0	1	0	0	1
Gold Diggers of 1933	0	1	0	0	0	1
Who Am I (Kein System Ist Sicher)	0	0	0	1	0	1
Porky in Wackyland	0	1	0	0	0	1
Tale of Princess Kaguya, The (Kaguyahime no monogatari)	0	0	0	0	1	1
The Wooden Horse	0	0	1	0	0	1
Atalante, L'	1	0	0	0	0	1
Tusk	0	1	0	0	0	1
High and Low (Tengoku to jigoku)	0	1	0	0	0	1
Horns	0	0	1	0	0	1
Night Flier	0	1	0	0	0	1
Libeled Lady	0	1	0	0	0	1
Stray Dog (Nora inu)	0	1	0	0	0	1
Desperate Living	0	1	0	0	0	1
Autómata (Automata)	0	0	1	0	0	1
Captive, The	0	0	0	1	0	1
Four Days in September (O Que É Isso, Companheiro?)	1	0	0	0	0	1
Fallen Angels (Duo luo tian shi)	0	0	0	1	0	1
Justin and the Knights of Valour	0	0	0	1	0	1
Ward 13	0	1	0	0	0	1
Plastic	0	0	0	1	0	1
Judge, The	0	0	1	0	0	1
Culture High, The	0	0	1	0	0	1
Salvation, The	0	0	1	0	0	1
Senseless	0	0	0	1	0	1
3 Ninjas: High Noon On Mega Mountain	0	1	0	0	0	1
Gidget	0	1	0	0	0	1
Rewrite, The	0	1	0	0	0	1
Frankenstein Must Be Destroyed	0	0	1	0	0	1
Love, Rosie	0	1	0	0	0	1
Court Jester, The	0	1	0	0	0	1
Navigator, The	0	1	0	0	0	1
Shot in the Dark, A	0	0	1	0	0	1
The Grandmother	0	0	1	0	0	1
Woman Under the Influence, A	1	0	0	0	0	1
Red River	0	1	0	0	0	1
Onibaba	1	0	0	0	0	1
Crippled Avengers (Can que) (Return of the 5 Deadly Venoms)	1	0	0	0	0	1
Birth of a Nation, The	0	0	0	1	0	1
Robinson Crusoe on Mars	0	0	0	1	0	1
Major Dundee	0	0	0	1	0	1
Birdman of Alcatraz	0	1	0	0	0	1
Dark Victory	0	1	0	0	0	1
Webmaster	0	0	1	0	0	1
Mr Hublot	0	0	1	0	0	1
Life with Father	0	1	0	0	0	1
Midsummer Night's Dream, A	0	1	0	0	0	1
Copenhagen	1	0	0	0	0	1
Swing Time	0	1	0	0	0	1
Generation War	0	1	0	0	0	1
Roberta	0	1	0	0	0	1
Mary of Scotland	0	0	1	0	0	1
Christmas in Connecticut	0	0	0	1	0	1
Leviathan	0	0	0	1	0	1
Flying Down to Rio	0	0	1	0	0	1
Thousand Clowns, A	1	0	0	0	0	1
Year of the Dragon	0	0	1	0	0	1
Andrei Rublev (Andrey Rublyov)	1	0	0	0	0	1
Reign of Assassins	0	0	1	0	0	1
Zulu	0	0	0	1	0	1
Trapped in Paradise	0	0	1	0	0	1
To Live and Die in L.A.	0	0	1	0	0	1
Things You Can Tell Just by Looking at Her	0	1	0	0	0	1
High Heels (Tacones lejanos)	1	0	0	0	0	1
Closely Watched Trains (Ostre sledované vlaky)	0	1	0	0	0	1
Master of the Flying Guillotine (Du bi quan wang da po xue di zi)	1	0	0	0	0	1
Branded to Kill (Koroshi no rakuin)	1	0	0	0	0	1
Revenge	0	1	0	0	0	1
Real McCoy, The	0	1	0	0	0	1
Tangerines	1	0	0	0	0	1
Life Partners	0	0	1	0	0	1
Titicut Follies	0	0	1	0	0	1
Drive Hard	0	0	0	1	0	1
New Kids Nitro	0	0	1	0	0	1
Vigilante Diaries	0	0	0	0	1	1
Wedding Banquet, The (Xi yan)	1	0	0	0	0	1
Stalingrad	0	0	1	0	0	1
Ride the High Country	0	1	0	0	0	1
Sympathy for the Devil	0	0	1	0	0	1
Jimmy Hollywood	0	0	1	0	0	1
Batman: The Killing Joke	0	0	1	0	0	1
Inkwell, The	0	0	0	0	1	1
Volga - Volga	0	1	0	0	0	1
Mr. Destiny	0	0	1	0	0	1
Kingsglaive: Final Fantasy XV	0	1	0	0	0	1
Body	0	0	0	0	1	1
Claire's Knee (Genou de Claire, Le)	1	0	0	0	0	1
Performance	0	1	0	0	0	1
King Ralph	0	0	0	1	0	1
White Sun of the Desert, The (Beloe solntse pustyni)	0	1	0	0	0	1
Zabriskie Point	0	1	0	0	0	1
You Are the Apple of My Eye	0	1	0	0	0	1
Hazard	0	0	1	0	0	1
House of Cards	0	0	0	1	0	1
A Home at the End of the World	0	1	0	0	0	1
Dr. Phibes Rises Again	1	0	0	0	0	1
Last Man on Earth, The (Ultimo uomo della Terra, L')	0	0	1	0	0	1
Charley Varrick	0	0	1	0	0	1
DeadHeads	0	1	0	0	0	1
The Great Train Robbery	0	1	0	0	0	1
Dark Star	0	0	1	0	0	1
Sisters	0	1	0	0	0	1
Ben-Hur: A Tale of the Christ	0	0	1	0	0	1
Turkish Delight (Turks fruit)	0	1	0	0	0	1
Tale of Two Cities, A	0	1	0	0	0	1
Jane Eyre	1	0	0	0	0	1
Forbidden Games (Jeux interdits)	0	1	0	0	0	1
Rudderless	1	0	0	0	0	1
California Split	0	1	0	0	0	1
Emmanuelle	0	1	0	0	0	1
Sex Ed	0	0	1	0	0	1
French Connection II	0	0	1	0	0	1
Final Analysis	0	0	1	0	0	1
Europa (Zentropa)	0	1	0	0	0	1
D.O.A.	0	0	1	0	0	1
Dernier Combat, Le (Last Battle, The)	1	0	0	0	0	1
Dead of Night	0	0	0	0	1	1
Sharknado 4: The 4th Awakens	0	0	0	1	0	1
Journeys with George	0	1	0	0	0	1
Jetsons: The Movie	0	0	0	1	0	1
OT: Our Town	0	1	0	0	0	1
Damage (Fatale)	0	1	0	0	0	1
Ski School	0	0	0	1	0	1
Irony of Fate, or Enjoy Your Bath! (Ironiya sudby, ili S legkim parom!)	0	1	0	0	0	1
Passenger, The (Professione: reporter)	1	0	0	0	0	1
Elle	0	1	0	0	0	1
Trilogy of Terror	0	1	0	0	0	1
1900 (Novecento)	1	0	0	0	0	1
Futureworld	0	0	1	0	0	1
House Party 3	0	0	0	0	1	1
Big Empty, The	0	1	0	0	0	1
Tupac: Resurrection	0	1	0	0	0	1
Harlan County U.S.A.	1	0	0	0	0	1
Porky's Hare Hunt	0	1	0	0	0	1
I Love You, I Love You Not	0	0	1	0	0	1
High Anxiety	0	1	0	0	0	1
New York, New York	0	0	1	0	0	1
Gloomy Sunday (Ein Lied von Liebe und Tod)	0	1	0	0	0	1
Billabong Odyssey	0	1	0	0	0	1
Turning Point, The	0	1	0	0	0	1
Revolution Will Not Be Televised, The (a.k.a. Chavez: Inside the Coup)	0	1	0	0	0	1
Five Deadly Venoms	0	1	0	0	0	1
Last Hurrah for Chivalry (Hao xia)	1	0	0	0	0	1
Human Stain, The	0	1	0	0	0	1
Train to Busan	0	1	0	0	0	1
The Longest Week	0	0	0	1	0	1
You'll Never Get Rich	0	1	0	0	0	1
Jolson Story, The	0	1	0	0	0	1
Miss Meadows	0	0	1	0	0	1
Sweet Dreams	0	0	1	0	0	1
Alien from L.A.	0	1	0	0	0	1
Tom Segura: Mostly Stories	1	0	0	0	0	1
Painted Skin	0	1	0	0	0	1
Virunga	0	1	0	0	0	1
Chairman of the Board	0	0	0	1	0	1
Love at First Bite	0	1	0	0	0	1
The Madagascar Penguins in a Christmas Caper	0	1	0	0	0	1
Beyond Borders	0	1	0	0	0	1
Live Nude Girls	1	0	0	0	0	1
Critical Care	0	0	0	1	0	1
Sylvia	0	0	1	0	0	1
Returner (Ritaanaa)	0	0	1	0	0	1
Smiley's People	0	1	0	0	0	1
Blue Thunder	0	0	1	0	0	1
Day After, The	0	0	1	0	0	1
Norte, El	0	1	0	0	0	1
Boy Meets Girl	0	0	1	0	0	1
Song of the Sea	0	0	1	0	0	1
Incognito	0	1	0	0	0	1
	1	0	0	0	0	1
Silent Night, Deadly Night	0	1	0	0	0	1
Hello Ladies: The Movie	0	0	1	0	0	1
What Have I Done to Deserve This? (¿Qué he hecho yo para merecer esto!!)	0	1	0	0	0	1
Watermark	1	0	0	0	0	1
Mobsters	0	0	0	1	0	1
They Drive by Night	0	1	0	0	0	1
Death of a Salesman	0	0	1	0	0	1
Deceiver	0	0	1	0	0	1
Campus Man	0	0	0	0	1	1
Once Upon a Time... When We Were Colored	0	0	1	0	0	1
Hit by Lightning	0	0	1	0	0	1
Bridget Jones's Baby	0	0	0	0	1	1
Love Affair	0	0	1	0	0	1
Amazing Transparent Man, The	0	1	0	0	0	1
Alien Contamination	1	0	0	0	0	1
Double Trouble	0	0	0	0	1	1
Deepwater Horizon	0	1	0	0	0	1
More American Graffiti	0	0	1	0	0	1
Dragonheart 2: A New Beginning	1	0	0	0	0	1
Ox-Bow Incident, The	1	0	0	0	0	1
White Hunter, Black Heart	0	0	1	0	0	1
Three O'Clock High	0	1	0	0	0	1
City Heat	0	0	1	0	0	1
Switchback	0	0	1	0	0	1
Eve's Bayou	0	0	1	0	0	1
White Nights	0	0	1	0	0	1
Tightrope	0	0	1	0	0	1
Hurricane Streets	0	1	0	0	0	1
Club Paradise	0	0	0	1	0	1
Crimewave	0	0	0	1	0	1
Phenomena (a.k.a. Creepers)	0	1	0	0	0	1
Iron Soldier	0	0	0	0	1	1
La Belle Verte	1	0	0	0	0	1
Bugsy	0	0	1	0	0	1
Decalogue, The (Dekalog)	1	0	0	0	0	1
G.I. Joe: The Movie	0	0	0	1	0	1
Hell Comes to Frogtown	0	0	0	1	0	1
Law of Desire (Ley del deseo, La)	0	1	0	0	0	1
The Girl on the Train	1	0	0	0	0	1
Apartment, The (Appartement, L')	0	1	0	0	0	1
Angie	0	0	0	1	0	1
Prince of Darkness	1	0	0	0	0	1
Swept from the Sea	0	1	0	0	0	1
Phantoms	0	1	0	0	0	1
Imperium	0	0	1	0	0	1
Leningrad Cowboys Go America	0	1	0	0	0	1
FairyTale: A True Story	0	1	0	0	0	1
Dominick and Eugene	0	0	1	0	0	1
Kizumonogatari Part 1: Tekketsu	0	1	0	0	0	1
Life and Debt	0	1	0	0	0	1
Moonwalker	0	0	1	0	0	1
'71	0	1	0	0	0	1
To Be and to Have (Être et avoir)	0	0	1	0	0	1
Year of the Horse	1	0	0	0	0	1
Mambo Italiano	0	0	1	0	0	1
Luther	0	1	0	0	0	1
Life Is a Long Quiet River (La vie est un long fleuve tranquille)	0	1	0	0	0	1
The Plague of the Zombies	0	0	1	0	0	1
Almost an Angel	0	0	1	0	0	1
The Second Renaissance Part II	0	1	0	0	0	1
The Rabbi's Cat (Le chat du rabbin)	0	0	1	0	0	1
It	0	1	0	0	0	1
Ju Dou	0	1	0	0	0	1
Fighting Temptations, The	0	1	0	0	0	1
Cold Creek Manor	0	0	1	0	0	1
Steins;Gate the Movie: The Burden of Déjà vu	0	0	1	0	0	1
Brood, The	0	0	1	0	0	1
Squirm	0	0	0	1	0	1
Krays, The	0	1	0	0	0	1
A Christmas Story Live!	0	0	0	1	0	1
Ice Age: A Mammoth Christmas	0	1	0	0	0	1
Lionheart	0	0	0	0	1	1
The Voices	0	1	0	0	0	1
Courier	0	1	0	0	0	1
Once Upon a Time in China II (Wong Fei-hung Ji Yi: Naam yi dong ji keung)	0	0	1	0	0	1
Patlabor: The Movie (Kidô keisatsu patorebâ: The Movie)	0	0	1	0	0	1
The Green Prince	0	0	1	0	0	1
Gotcha!	0	0	1	0	0	1
Children of the Night	0	1	0	0	0	1
Notorious C.H.O.	0	1	0	0	0	1
Days of Being Wild (A Fei jingjyuhn)	1	0	0	0	0	1
Begotten	0	0	0	0	1	1
Dutch	0	0	1	0	0	1
Johnny Stecchino	0	1	0	0	0	1
Riki-Oh: The Story of Ricky (Lik Wong)	1	0	0	0	0	1
Taking Sides	0	1	0	0	0	1
Party Monster	0	0	1	0	0	1
Mannequin 2: On the Move	0	0	0	1	0	1
Once Upon a Time in the Midlands	0	0	1	0	0	1
Bollywood/Hollywood	0	0	1	0	0	1
Only Yesterday (Omohide poro poro)	0	0	1	0	0	1
Stoked: The Rise and Fall of Gator	0	0	0	1	0	1
Dust	0	0	1	0	0	1
Battle of Shaker Heights, The	0	1	0	0	0	1
Autumn Spring (Babí léto)	0	1	0	0	0	1
Other People's Money	0	0	1	0	0	1
Dying of the Light	0	0	0	1	0	1
Hellbenders	1	0	0	0	0	1
Revolution OS	0	1	0	0	0	1
Handmaid's Tale, The	0	1	0	0	0	1
Angel at My Table, An	0	1	0	0	0	1
Omega Doom	0	0	0	1	0	1
Prime Suspect 2	0	0	1	0	0	1
Waco: The Rules of Engagement	0	1	0	0	0	1
By the Gun	0	0	0	1	0	1
Dracula	1	0	0	0	0	1
Assignment, The	1	0	0	0	0	1
Stolen Children (Ladro di bambini, Il)	0	1	0	0	0	1
Mambo Kings, The	0	0	0	1	0	1
Red Shoes, The	0	1	0	0	0	1
Shining Through	0	0	0	1	0	1
The Maid's Room	0	0	0	1	0	1
Attack of the Puppet People	0	1	0	0	0	1
Atragon (Kaitei Gunkan)	0	1	0	0	0	1
Shin Godzilla	0	1	0	0	0	1
Heart in Winter, A (Un coeur en hiver)	0	1	0	0	0	1
Green Ray, The (Rayon vert, Le)	0	1	0	0	0	1
Visions of Light: The Art of Cinematography	0	0	1	0	0	1
Kill the Messenger	0	0	1	0	0	1
Winnie Pooh	1	0	0	0	0	1
Fortress	0	0	1	0	0	1
Pixel Perfect	1	0	0	0	0	1
Winnie the Pooh Goes Visiting	1	0	0	0	0	1
Hot Dog... The Movie	0	0	0	1	0	1
Mr. Nanny	0	0	0	1	0	1
Snapper, The	0	0	1	0	0	1
Sonatine (Sonachine)	1	0	0	0	0	1
Stand, The	1	0	0	0	0	1
Darkman II: Return of Durant, The	0	0	1	0	0	1
Freaked	0	1	0	0	0	1
Bring It On: In It To Win It	0	0	0	1	0	1
Testament of Dr. Mabuse, The (Das Testament des Dr. Mabuse)	0	1	0	0	0	1
BlacKkKlansman	0	0	1	0	0	1
Dark Passage	0	1	0	0	0	1
Umberto D.	1	0	0	0	0	1
Gospel According to St. Matthew, The (Vangelo secondo Matteo, Il)	0	1	0	0	0	1
Hawks and Sparrows (Uccellacci e Uccellini)	0	1	0	0	0	1
Double Life, A	0	0	1	0	0	1
Step Into Liquid	0	1	0	0	0	1
Princess Blade, The (Shura Yukihime)	0	0	1	0	0	1
Divorce, Le	0	1	0	0	0	1
Pure Formality, A (Pura formalità, Una)	0	1	0	0	0	1
Langoliers, The	0	0	1	0	0	1
Secret Lives of Dentists, The	0	1	0	0	0	1
Last Wedding, The (Kivenpyörittäjän kylä)	0	0	1	0	0	1
And Now... Ladies and Gentlemen...	0	1	0	0	0	1
Gigli	0	0	0	1	0	1
Last of the Dogmen	0	0	1	0	0	1
Flesh and Bone	0	1	0	0	0	1
Blood of Heroes, The (Salute of the Jugger, The)	0	1	0	0	0	1
Winnie the Pooh and the Day of Concern	1	0	0	0	0	1
Lammbock	1	0	0	0	0	1
Fans	1	0	0	0	0	1
Kiss Me, Stupid	0	1	0	0	0	1
The Red Turtle	1	0	0	0	0	1
Eve of Destruction	0	0	0	0	1	1
Avanti!	0	1	0	0	0	1
Black Orpheus (Orfeu Negro)	0	1	0	0	0	1
Mondays in the Sun (Lunes al sol, Los)	0	1	0	0	0	1
Black Sea	0	1	0	0	0	1
Fear of a Black Hat	0	0	0	0	1	1
Comedy Central Roast of David Hasselhoff	0	1	0	0	0	1
Street Fighter II: The Animated Movie (Sutorîto Faitâ II gekijô-ban)	0	0	0	1	0	1
Summer's Tale, A (Conte d'été)	1	0	0	0	0	1
Masked & Anonymous	0	0	1	0	0	1
Mouse That Roared, The	0	0	1	0	0	1
Loose Cannons	0	0	0	1	0	1
Late Shift, The	0	0	1	0	0	1
DC Super Hero Girls: Hero of the Year	0	1	0	0	0	1
Born to Be Wild	0	0	0	0	1	1
Good Copy Bad Copy	0	1	0	0	0	1
Embalmer, The (Imbalsamatore, L')	0	1	0	0	0	1
Pusher	0	0	1	0	0	1
Anarchist Cookbook, The	0	1	0	0	0	1
Emma	0	1	0	0	0	1
David Cross: Making America Great Again	0	0	1	0	0	1
Playing It Cool	0	0	0	1	0	1
Star Maps	0	1	0	0	0	1
I Capture the Castle	1	0	0	0	0	1
Cuckoo, The (Kukushka)	0	1	0	0	0	1
Nirvana	1	0	0	0	0	1
SuperFly	0	0	1	0	0	1
From the Earth to the Moon	0	1	0	0	0	1
Beowulf	0	0	1	0	0	1
RKO 281	0	1	0	0	0	1
From Dusk Till Dawn 2: Texas Blood Money	0	0	0	0	1	1
Thursday	0	1	0	0	0	1
What's Up, Doc?	1	0	0	0	0	1
National Lampoon's Bag Boy	1	0	0	0	0	1
Start the Revolution Without Me	0	0	0	1	0	1
Scaramouche	0	0	1	0	0	1
Closer to the Moon	0	1	0	0	0	1
Flint	0	1	0	0	0	1
Anastasia	0	1	0	0	0	1
You Only Live Once	1	0	0	0	0	1
Ring of Terror	0	0	0	0	1	1
Bodies, Rest & Motion	0	0	1	0	0	1
Love Crazy	0	1	0	0	0	1
Fulltime Killer (Chuen jik sat sau)	0	1	0	0	0	1
Nico Icon	0	1	0	0	0	1
Merlin	0	0	1	0	0	1
Alex and Emma	0	0	0	1	0	1
Brave New World	0	0	0	1	0	1
Over the Garden Wall	0	0	1	0	0	1
Addams Family Reunion	0	0	1	0	0	1
Thoroughly Modern Millie	0	0	1	0	0	1
Song of Bernadette, The	0	0	1	0	0	1
Shattered	0	0	1	0	0	1
Wings, Legs and Tails	1	0	0	0	0	1
Jubilee	0	0	1	0	0	1
Song of the Thin Man	0	1	0	0	0	1
Purgatory	0	0	1	0	0	1
Bleeder	0	0	0	1	0	1
Music Box	0	1	0	0	0	1
Man of Aran	0	1	0	0	0	1
Long, Hot Summer, The	0	1	0	0	0	1
From the Terrace	0	0	1	0	0	1
Judd Apatow: The Return	0	0	1	0	0	1
Scooby-Doo! Abracadabra-Doo	1	0	0	0	0	1
Dark Portals: The Chronicles of Vidocq  (Vidocq)	0	1	0	0	0	1
Blair Witch	0	1	0	0	0	1
Objective, Burma!	0	0	1	0	0	1
31	0	1	0	0	0	1
Winchester '73	0	1	0	0	0	1
Mommy	0	1	0	0	0	1
Railway Children, The	0	1	0	0	0	1
The Purple Sea	0	1	0	0	0	1
Oscar	0	0	0	0	1	1
Shenandoah	0	1	0	0	0	1
Live Wire	0	1	0	0	0	1
Intervista	0	1	0	0	0	1
Poetic Justice	0	0	1	0	0	1
The Commuter	0	0	0	1	0	1
Animals are Beautiful People	1	0	0	0	0	1
Walk, Don't Run	0	0	0	1	0	1
Shadow of the Thin Man	0	1	0	0	0	1
Siam Sunset	1	0	0	0	0	1
Murder on a Sunday Morning (Un coupable idéal)	0	1	0	0	0	1
Crazies, The (a.k.a. Code Name: Trixie)	0	1	0	0	0	1
Silk Stockings	0	1	0	0	0	1
ARQ	1	0	0	0	0	1
Nevada Smith	0	1	0	0	0	1
Candyman 3: Day of the Dead	0	0	1	0	0	1
Batman/Superman Movie, The	0	0	0	1	0	1
Together (Han ni Zai Yiki)	0	0	1	0	0	1
Style Wars	1	0	0	0	0	1
Bill Burr: I'm Sorry You Feel That Way	1	0	0	0	0	1
In July (Im Juli)	0	1	0	0	0	1
Dave Chappelle: Equanimity	0	1	0	0	0	1
Thin Man Goes Home, The	0	1	0	0	0	1
If These Walls Could Talk 2	0	1	0	0	0	1
Men, Women & Children	0	0	0	1	0	1
Bill Burr: You People Are All the Same	1	0	0	0	0	1
Pokémon Heroes	0	0	0	0	1	1
Wind Will Carry Us, The (Bad ma ra khahad bord)	0	1	0	0	0	1
Bartleby	0	0	0	1	0	1
Nine Lives of Tomas Katz, The	1	0	0	0	0	1
Monday	1	0	0	0	0	1
Kiss Me Kate	0	1	0	0	0	1
Paradox	0	1	0	0	0	1
Paradise Lost 2: Revelations	0	1	0	0	0	1
Maximum Ride	1	0	0	0	0	1
Endless Poetry	0	1	0	0	0	1
Beat Street	0	0	0	0	1	1
The Girl with All the Gifts	1	0	0	0	0	1
101 Reykjavik (101 Reykjavík)	0	1	0	0	0	1
Trip, The	0	0	0	1	0	1
Daria: Is It Fall Yet?	0	1	0	0	0	1
Late Night Shopping	1	0	0	0	0	1
61*	1	0	0	0	0	1
The Punisher: Dirty Laundry	0	0	1	0	0	1
Marooned in Iraq (Gomgashtei dar Aragh)	0	0	1	0	0	1
All Roads Lead to Rome	0	0	0	1	0	1
Amanda Knox	0	1	0	0	0	1
Teknolust	0	0	0	1	0	1
Accidental Spy, The (Dak miu mai shing)	0	0	1	0	0	1
Another Thin Man	0	1	0	0	0	1
Corner Gas: The Movie	0	1	0	0	0	1
Manic	0	0	1	0	0	1
Dirty 30	0	0	1	0	0	1
A Man Called Blade	0	0	1	0	0	1
Blueberry	0	0	1	0	0	1
American Psycho II: All American Girl	0	0	1	0	0	1
A Merry Friggin' Christmas	0	0	0	1	0	1
Love Serenade	0	0	1	0	0	1
Wiz, The	0	0	0	1	0	1
Gimme Danger	0	0	0	1	0	1
Into the Forest of Fireflies' Light	1	0	0	0	0	1
Secret Life of Walter Mitty, The	0	1	0	0	0	1
Memories of Me	0	0	1	0	0	1
Dead or Alive 2: Tôbôsha	1	0	0	0	0	1
Go Figure	0	1	0	0	0	1
PK	1	0	0	0	0	1
Pulse (Kairo)	0	0	1	0	0	1
Beginning of the End	0	0	0	0	1	1
Dog Days (Hundstage)	0	0	1	0	0	1
Anything for Love	0	0	0	1	0	1
My Sassy Girl (Yeopgijeogin geunyeo)	1	0	0	0	0	1
Night Guards	0	0	0	1	0	1
Nothing	0	1	0	0	0	1
Undertaking Betty (Plots with a View)	0	0	1	0	0	1
Chasing Papi (a.k.a. Papi Chulo)	0	0	0	1	0	1
Dead or Alive: Final	0	0	0	1	0	1
Quest	0	1	0	0	0	1
The Fool	1	0	0	0	0	1
Ghosts of the Abyss	0	1	0	0	0	1
Fall	0	0	0	0	1	1
Jesus Christ Vampire Hunter	0	0	0	0	1	1
Mogambo	0	0	1	0	0	1
Levity	0	1	0	0	0	1
People Will Talk	0	1	0	0	0	1
Oasis	1	0	0	0	0	1
True Stories	1	0	0	0	0	1
Good Thief, The	0	1	0	0	0	1
In a Lonely Place	0	1	0	0	0	1
Day for Night (La Nuit Américaine)	0	0	0	1	0	1
The Darkest Minds	0	1	0	0	0	1
By the Law	0	1	0	0	0	1
Son of a Gun	0	0	1	0	0	1
Assassination Tango	0	0	0	1	0	1
Remember Me (Ricordati di me)	0	1	0	0	0	1
Head Above Water	0	1	0	0	0	1
Sympathy for the Underdog	1	0	0	0	0	1
John Mulaney: New In Town	0	1	0	0	0	1
Patton Oswalt: My Weakness Is Strong	1	0	0	0	0	1
Ju-on: The Curse	0	0	1	0	0	1
Piglet's Big Movie	0	0	0	1	0	1
Tremors 4: The Legend Begins	0	0	0	1	0	1
The Hound of the Baskervilles	0	0	1	0	0	1
Talent for the Game	0	1	0	0	0	1
Sweet Charity	0	1	0	0	0	1
Man on High Heels	0	0	1	0	0	1
Crimson Rivers 2: Angels of the Apocalypse (Rivières pourpres II - Les anges de l'apocalypse, Les)	0	0	1	0	0	1
Pauline at the Beach (Pauline à la Plage)	0	1	0	0	0	1
Dave Chappelle: The Bird Revelation	0	1	0	0	0	1
And Starring Pancho Villa as Himself	0	1	0	0	0	1
Glenn Miller Story, The	0	1	0	0	0	1
Space Buddies	0	1	0	0	0	1
Equus	0	1	0	0	0	1
Born Free	0	1	0	0	0	1
Talk of the Town, The	0	1	0	0	0	1
King of Kings	0	0	1	0	0	1
Rough Magic	0	1	0	0	0	1
Prozac Nation	0	0	1	0	0	1
Nicotina	0	0	1	0	0	1
London Town	0	0	1	0	0	1
Battle Royale 2: Requiem (Batoru rowaiaru II: Chinkonka)	1	0	0	0	0	1
Babylon 5: The River of Souls	0	1	0	0	0	1
Schizopolis	0	1	0	0	0	1
Satanic	0	0	0	0	1	1
In Hell	0	0	0	1	0	1
Helen of Troy	0	1	0	0	0	1
Green Butchers, The (Grønne slagtere, De)	1	0	0	0	0	1
Volcano High (Whasango)	0	0	1	0	0	1
Meteor Man, The	0	0	1	0	0	1
Houdini	0	0	0	1	0	1
Late Marriage (Hatuna Meuheret)	0	1	0	0	0	1
Lady Jane	1	0	0	0	0	1
Wild Oats	0	0	0	1	0	1
The Rocky Horror Picture Show: Let's Do the Time Warp Again	0	0	0	1	0	1
Man Escaped, A (Un  condamné à mort s'est échappé ou Le vent souffle où il veut)	0	1	0	0	0	1
101 Dalmatians II: Patch's London Adventure	0	0	1	0	0	1
Open Hearts (Elsker dig for evigt)	1	0	0	0	0	1
Facing Windows (Finestra di fronte, La)	1	0	0	0	0	1
Ginger Snaps: Unleashed	0	0	1	0	0	1
Gods and Generals	0	0	1	0	0	1
Jack Reacher: Never Go Back	0	0	0	1	0	1
'Salem's Lot	1	0	0	0	0	1
Joe Rogan: Triggered	0	1	0	0	0	1
Thrill of It All, The	0	0	1	0	0	1
Red Badge of Courage, The	0	1	0	0	0	1
Patch of Blue, A	0	1	0	0	0	1
Ethel & Ernest	0	0	1	0	0	1
The Hungover Games	0	0	1	0	0	1
Comic Book: The Movie	0	0	1	0	0	1
He Loves Me... He Loves Me Not (À la folie... pas du tout)	1	0	0	0	0	1
Flowers for Algernon	0	0	0	1	0	1
Madhouse	0	1	0	0	0	1
Jungle Book 2, The	0	0	1	0	0	1
Insidious: The Last Key	0	1	0	0	0	1
Down to the Bone	0	0	1	0	0	1
Red Lights (Feux rouges)	1	0	0	0	0	1
The Duke of Burgundy	0	1	0	0	0	1
Lion	1	0	0	0	0	1
Venom	0	0	0	1	0	1
The Tale of the Bunny Picnic	0	0	1	0	0	1
They Call Me Bruce? (a.k.a. A Fistful of Chopsticks)	0	0	1	0	0	1
Broken English	0	0	0	0	1	1
Secret Policeman's Other Ball, The	0	1	0	0	0	1
Red Army	0	1	0	0	0	1
Sunless (Sans Soleil)	0	1	0	0	0	1
The Town that Dreaded Sundown	0	0	1	0	0	1
Santa Claus Is a Stinker (Le Père Noël est une ordure)	0	1	0	0	0	1
Children of the Revolution	0	0	1	0	0	1
Paradise	0	1	0	0	0	1
Night of the Shooting Stars (Notte di San Lorenzo, La)	0	1	0	0	0	1
Ginger Snaps Back: The Beginning	0	0	1	0	0	1
Missing	0	1	0	0	0	1
The Thinning	0	0	0	0	1	1
Dragon Lord (a.k.a. Dragon Strike) (Long Xiao Ye)	0	1	0	0	0	1
One Missed Call (Chakushin ari)	0	0	0	1	0	1
Kiss Me Goodbye	0	1	0	0	0	1
I, the Jury	1	0	0	0	0	1
Carry on Cabby	1	0	0	0	0	1
Tokyo Decadence (Topâzu)	0	1	0	0	0	1
Ordinary Decent Criminal	0	1	0	0	0	1
Harder They Fall, The	0	1	0	0	0	1
Bad Santa 2	0	0	0	0	1	1
Temptress Moon (Feng Yue)	0	0	1	0	0	1
Carry on Cruising	0	1	0	0	0	1
Infernal Affairs 2 (Mou gaan dou II)	0	0	1	0	0	1
Saints and Soldiers	0	0	1	0	0	1
Biker Boyz	0	0	0	1	0	1
Paradise Road	0	1	0	0	0	1
Above the Rim	0	0	0	1	0	1
Ethan Frome	0	1	0	0	0	1
Blind Date	0	0	0	1	0	1
Blind Spot: Hitler's Secretary (Im toten Winkel - Hitlers Sekretärin)	0	0	1	0	0	1
Bill Burr: Let It Go	1	0	0	0	0	1
Genghis Blues	0	1	0	0	0	1
Touch of Pink	0	1	0	0	0	1
Secret Admirer	0	0	1	0	0	1
Bill Burr: Why Do I Do This?	1	0	0	0	0	1
Mystery Date	0	0	1	0	0	1
Killer Movie	1	0	0	0	0	1
Girls! Girls! Girls!	0	0	0	1	0	1
Ice Guardians	1	0	0	0	0	1
Slasher	0	1	0	0	0	1
Sebastian Maniscalco: What's Wrong with People?	0	1	0	0	0	1
Federal Hill	0	0	1	0	0	1
American Friend, The (Amerikanische Freund, Der)	1	0	0	0	0	1
Alice Adams	0	1	0	0	0	1
Bobby Jones, Stroke of Genius	0	0	1	0	0	1
Patti Rocks	1	0	0	0	0	1
Anna Karenina	0	1	0	0	0	1
Hellevator	0	0	0	0	1	1
City of Lost Souls, The (Hyôryuu-gai)	0	0	1	0	0	1
Love and Other Catastrophes	0	1	0	0	0	1
Risk	0	1	0	0	0	1
In My Father's Den	0	1	0	0	0	1
Twister	0	0	0	1	0	1
Tae Guk Gi: The Brotherhood of War (Taegukgi hwinalrimyeo)	1	0	0	0	0	1
Wind and the Lion, The	0	0	1	0	0	1
Stuart Little 3: Call of the Wild	1	0	0	0	0	1
Guy X	1	0	0	0	0	1
Casshern	0	1	0	0	0	1
Tooth Fairy 2	0	0	0	0	1	1
Beyond the Sea	0	0	0	1	0	1
Pinocchio	0	1	0	0	0	1
Game Night	0	1	0	0	0	1
The Diary of Anne Frank	0	0	1	0	0	1
Fat City	0	1	0	0	0	1
The Deadly Bees	0	0	0	0	1	1
Wicked Blood	0	0	0	1	0	1
Attack of the Crab Monsters	0	0	1	0	0	1
War and Peace	0	1	0	0	0	1
Thief of Bagdad, The	0	0	1	0	0	1
Keys to the House, The (Chiavi di casa, Le)	0	0	1	0	0	1
Little Miss Marker	0	1	0	0	0	1
My Girl 2	0	0	1	0	0	1
Miami Blues	0	1	0	0	0	1
Jason's Lyric	1	0	0	0	0	1
Love Jones	0	1	0	0	0	1
Body of Evidence	0	0	0	0	1	1
Blue Steel	0	0	0	1	0	1
Sweet Liberty	0	0	1	0	0	1
I Remember Mama	0	1	0	0	0	1
Smooth Talk	0	1	0	0	0	1
Out Cold	0	0	1	0	0	1
Man Trouble	0	0	0	1	0	1
Devils on the Doorstep (Guizi lai le)	0	1	0	0	0	1
Battles Without Honor & Humanity (Jingi naki tatakai)	0	1	0	0	0	1
Oblivion 2: Backlash	0	0	0	0	1	1
Kama Sutra: A Tale of Love	0	1	0	0	0	1
Evelyn	0	0	1	0	0	1
Undercurrent	0	1	0	0	0	1
Ruby & Quentin (Tais-toi!)	0	0	1	0	0	1
Wizards	0	0	0	1	0	1
Life and Death of Peter Sellers, The	0	0	1	0	0	1
Many Adventures of Winnie the Pooh, The	0	1	0	0	0	1
Best Men	0	1	0	0	0	1
Ben-hur	0	0	0	0	1	1
Party 2, The (Boum 2, La)	0	0	1	0	0	1
Best Little Whorehouse in Texas, The	0	0	1	0	0	1
Elsa & Fred	0	0	0	1	0	1
Attila (Attila Flagello di Dio)	0	0	1	0	0	1
Maze Runner: The Death Cure	0	1	0	0	0	1
Jim Jefferies: I Swear to God	1	0	0	0	0	1
Hit the Bank (Vabank)	1	0	0	0	0	1
Racing Stripes	0	0	0	1	0	1
Boys Town	0	1	0	0	0	1
Gold Diggers of 1935	0	1	0	0	0	1
Empire	1	0	0	0	0	1
Rocco and His Brothers (Rocco e i suoi fratelli)	0	1	0	0	0	1
Chase, The	0	0	0	1	0	1
New Waterford Girl	0	1	0	0	0	1
Tornado!	0	0	0	1	0	1
Are We There Yet?	0	0	0	0	1	1
Beyond Re-Animator	0	0	1	0	0	1
Cruel Romance, A (Zhestokij Romans)	1	0	0	0	0	1
Brother (Brat)	1	0	0	0	0	1
Chopper Chicks in Zombietown	0	0	0	0	1	1
They	0	0	0	1	0	1
Alone in the Dark	0	0	0	0	1	1
The Blue Lagoon	0	0	1	0	0	1
Touch	0	1	0	0	0	1
Rory O'Shea Was Here (Inside I'm Dancing)	1	0	0	0	0	1
In the Name of the King III	0	0	0	0	1	1
Pest, The	0	0	0	1	0	1
Personal Velocity	0	0	1	0	0	1
Marriage of Maria Braun, The (Ehe der Maria Braun, Die)	1	0	0	0	0	1
Trou, Le (Hole, The) (Night Watch, The)	0	1	0	0	0	1
Double Dragon	0	0	0	0	1	1
Miracle of Marcelino, The (Marcelino pan y vino)	0	1	0	0	0	1
Take This Job and Shove It	0	0	0	0	1	1
Do You Remember Dolly Bell? (Sjecas li se, Dolly Bell)	0	1	0	0	0	1
The Clapper	0	0	0	1	0	1
I'm Starting From Three (Ricomincio da Tre)	1	0	0	0	0	1
Ragtime	0	1	0	0	0	1
Hands Off the Loot (Touchez pas au grisbi)	0	0	1	0	0	1
Alesha Popovich and Tugarin the Dragon	1	0	0	0	0	1
My Mother's Castle (Château de ma mère, Le)	0	1	0	0	0	1
My Father's Glory (La gloire de mon père)	0	1	0	0	0	1
Madame Bovary	0	1	0	0	0	1
Houseboat	0	0	0	1	0	1
Kevin Smith: Too Fat For 40	1	0	0	0	0	1
Men with Brooms	0	1	0	0	0	1
Blackrock	0	0	1	0	0	1
Rio Grande	0	1	0	0	0	1
Snowflake, the White Gorilla	1	0	0	0	0	1
Crime of Father Amaro, The (Crimen del padre Amaro, El)	1	0	0	0	0	1
Ararat	1	0	0	0	0	1
Purple Butterfly (Zi hudie)	0	1	0	0	0	1
El Cid	0	0	1	0	0	1
Kenny & Company	0	0	1	0	0	1
Gorgeous (Boh lee chun)	0	1	0	0	0	1
Uncle Nino	0	0	0	0	1	1
Delirium	1	0	0	0	0	1
World of Henry Orient, The	0	1	0	0	0	1
Russians Are Coming, the Russians Are Coming, The	0	0	1	0	0	1
Exodus	0	1	0	0	0	1
Company of Wolves, The	0	0	0	1	0	1
Son of the Mask	0	0	0	0	1	1
Turtles Can Fly (Lakposhtha hâm parvaz mikonand)	0	1	0	0	0	1
Bunny Lake Is Missing	0	1	0	0	0	1
Why Man Creates	0	1	0	0	0	1
Truth About Charlie, The	0	0	1	0	0	1
Paid in Full	1	0	0	0	0	1
Sons of the Desert	0	0	1	0	0	1
Man of the House	0	0	1	0	0	1
Zelary	0	1	0	0	0	1
Polyester	0	0	1	0	0	1
Piranha II: The Spawning	0	0	0	1	0	1
Neighbors	0	0	1	0	0	1
The Gambler	0	0	0	1	0	1
My Bloody Valentine	0	0	0	0	1	1
Modern Problems	0	0	1	0	0	1
Teddy Bear (Mis)	0	1	0	0	0	1
Looker	1	0	0	0	0	1
Slaughterhouse-Five	0	1	0	0	0	1
Gregory's Girl	0	0	1	0	0	1
Ghost Story	0	0	1	0	0	1
Dr. Giggles	0	1	0	0	0	1
Galaxy of Terror (Quest)	1	0	0	0	0	1
Four Seasons, The	1	0	0	0	0	1
First Monday in October	0	1	0	0	0	1
Woman Next Door, The (Femme d'à côté, La)	0	1	0	0	0	1
Faces of Death 3	0	0	0	1	0	1
Tom Segura: Disgraceful	1	0	0	0	0	1
Eyewitness (Janitor, The)	0	1	0	0	0	1
Continental Divide	1	0	0	0	0	1
Friend Is a Treasure, A (Chi Trova Un Amico, Trova un Tesoro) (Who Finds a Friend Finds a Treasure)	0	0	1	0	0	1
Seven-Per-Cent Solution, The	0	0	1	0	0	1
The Beast of Hollow Mountain	0	0	0	0	1	1
Mr. Blandings Builds His Dream House	0	0	1	0	0	1
...All the Marbles	0	0	0	1	0	1
Without Warning (a.k.a. Alien Warning) (a.k.a. It Came Without Warning)	0	0	0	1	0	1
The Pumaman	0	0	0	0	1	1
Tom Horn	0	1	0	0	0	1
S.F.W.	0	0	1	0	0	1
Mortdecai	0	0	1	0	0	1
Royal Flash	0	1	0	0	0	1
Control (Kontroll)	0	1	0	0	0	1
Billy Bathgate	0	0	0	1	0	1
Halloweentown	0	1	0	0	0	1
Extraordinary Adventures of Adèle Blanc-Sec, The	0	0	1	0	0	1
Naqoyqatsi	0	0	1	0	0	1
When a Woman Ascends the Stairs (Onna ga kaidan wo agaru toki)	1	0	0	0	0	1
Man of No Importance, A	0	1	0	0	0	1
Germany Year Zero (Germania anno zero) (Deutschland im Jahre Null)	0	1	0	0	0	1
Weekend (a.k.a. Le Week-end) (Week End)	0	1	0	0	0	1
Swept Away	0	0	0	0	1	1
Class Action	0	0	0	1	0	1
Turbulence	0	0	0	0	1	1
Zeus and Roxanne	0	0	0	0	1	1
Cat and the Canary, The	0	0	1	0	0	1
Oh, God! You Devil	0	0	1	0	0	1
A Flintstones Christmas Carol	1	0	0	0	0	1
Agony and the Ecstasy, The	0	1	0	0	0	1
Elevator to the Gallows (a.k.a. Frantic) (Ascenseur pour l'échafaud)	0	1	0	0	0	1
Brown Sugar	0	0	0	1	0	1
Below	0	1	0	0	0	1
Flashback	1	0	0	0	0	1
Incredible Mr. Limpet, The	0	0	1	0	0	1
Julia	0	1	0	0	0	1
Horror of Dracula (Dracula)	0	0	1	0	0	1
Stealing Rembrandt (Rembrandt)	0	1	0	0	0	1
The African Doctor	0	1	0	0	0	1
Hearts and Minds	0	1	0	0	0	1
Godzilla, King of the Monsters! (Kaijû-ô Gojira)	0	0	1	0	0	1
Godzilla vs. Mothra (Mosura tai Gojira)	0	0	0	1	0	1
Hedgehog in the Fog	1	0	0	0	0	1
My Favorite Wife	0	0	1	0	0	1
Man from Elysian Fields, The	0	0	1	0	0	1
Scent of Green Papaya, The (Mùi du du xhan - L'odeur de la papaye verte)	0	1	0	0	0	1
Milk and Honey	0	1	0	0	0	1
League of Ordinary Gentlemen, A	0	1	0	0	0	1
Jonah: A VeggieTales Movie	0	0	0	1	0	1
Incident at Loch Ness	0	1	0	0	0	1
Junior and Karlson	1	0	0	0	0	1
The Cave of the Golden Rose	0	1	0	0	0	1
800 Bullets (800 Balas)	0	0	1	0	0	1
Blame It on the Bellboy	0	0	0	1	0	1
If Looks Could Kill	0	0	0	1	0	1
Greedy	0	0	1	0	0	1
Invincible	0	1	0	0	0	1
His Secret Life (a.k.a. Ignorant Fairies, The) (Fate ignoranti, Le)	1	0	0	0	0	1
Sapphire Blue	0	1	0	0	0	1
Trapped	0	0	0	1	0	1
American Heist	0	0	0	1	0	1
Baxter	0	0	0	0	1	1
Some Mother's Son	0	1	0	0	0	1
Solyaris	0	1	0	0	0	1
Son of the Bride (Hijo de la novia, El)	1	0	0	0	0	1
Man in the White Suit, The	0	1	0	0	0	1
Matinee	0	0	1	0	0	1
Ladykillers, The	0	1	0	0	0	1
Yearling, The	0	1	0	0	0	1
Strange Magic	0	0	1	0	0	1
Spaced Invaders	0	0	0	1	0	1
Monkey Trouble	0	0	0	0	1	1
Mack, The	0	0	1	0	0	1
The Space Between Us	0	0	0	0	1	1
Daddy, I'm A Zombie	0	1	0	0	0	1
We're No Angels	1	0	0	0	0	1
Ernest Goes to Jail	0	1	0	0	0	1
Touch of Zen, A (Xia nu)	1	0	0	0	0	1
Betsy's Wedding	0	0	0	1	0	1
Aspen Extreme	0	1	0	0	0	1
Walker	0	0	1	0	0	1
Alias Betty (Betty Fisher et autres histoires)	0	0	0	1	0	1
Ice Age: Collision Course	0	0	0	0	1	1
Beauty Shop	0	0	0	1	0	1
Eros	0	1	0	0	0	1
Not on the Lips (Pas sur la bouche)	0	1	0	0	0	1
The Fox and the Hound 2	1	0	0	0	0	1
Electra Glide in Blue	0	1	0	0	0	1
Battle Planet	0	0	0	1	0	1
Underworld: Blood Wars	0	0	1	0	0	1
Snipes	0	0	1	0	0	1
À nous la liberté (Freedom for Us)	0	0	0	0	1	1
The End of the Tour	0	1	0	0	0	1
Special Day, A (Giornata particolare, Una)	0	1	0	0	0	1
Love Me Tender	0	1	0	0	0	1
Tanguy	0	0	1	0	0	1
National Lampoon's Lady Killers (National Lampoon's Gold Diggers)	0	0	0	0	1	1
In Love and War	0	0	1	0	0	1
Little Girl Who Lives Down the Lane, The	0	1	0	0	0	1
Ringu 0: Bâsudei	0	0	1	0	0	1
Protocol	0	0	1	0	0	1
Experimenter	1	0	0	0	0	1
Satin Rouge	1	0	0	0	0	1
Amy's O (a.k.a. Amy's Orgasm)	0	1	0	0	0	1
Mistress America	0	1	0	0	0	1
Zipper	0	0	0	1	0	1
A Walk in the Woods	0	1	0	0	0	1
Maidens in Uniform (Mädchen in Uniform)	0	1	0	0	0	1
With Six You Get Eggroll	0	1	0	0	0	1
Mostly Martha (Bella Martha)	0	1	0	0	0	1
Holiday (Jour de fête)	0	0	1	0	0	1
Fences	0	0	1	0	0	1
New Adventures of Pippi Longstocking, The	0	0	1	0	0	1
Kurt Cobain: Montage of Heck	0	0	1	0	0	1
Songs From the Second Floor (Sånger från andra våningen)	0	1	0	0	0	1
Martin Lawrence Live: Runteldat	1	0	0	0	0	1
Lonely Guy, The	0	1	0	0	0	1
Ascent, The (Voskhozhdeniye)	0	1	0	0	0	1
Carrie	0	0	1	0	0	1
What Happened, Miss Simone?	0	1	0	0	0	1
Boccaccio '70	0	1	0	0	0	1
A Story of Children and Film	0	1	0	0	0	1
Last Kiss, The (Ultimo bacio, L')	0	1	0	0	0	1
Before the Fall (NaPolA - Elite für den Führer)	0	1	0	0	0	1
Frisco Kid, The	0	0	1	0	0	1
State Property 2	0	0	0	1	0	1
Story of Film: An Odyssey, The	0	1	0	0	0	1
Red Beard (Akahige)	1	0	0	0	0	1
I Am Not Your Negro	1	0	0	0	0	1
In Like Flint	0	1	0	0	0	1
The Big Bus	1	0	0	0	0	1
Nosferatu the Vampyre (Nosferatu: Phantom der Nacht)	0	1	0	0	0	1
Eden	0	1	0	0	0	1
Iron Man	0	0	0	0	1	1
The D Train	0	0	0	1	0	1
Palindromes	1	0	0	0	0	1
King's Ransom	0	0	1	0	0	1
Camelot	0	1	0	0	0	1
Mischief	0	0	1	0	0	1
Between Your Legs (Entre las piernas)	1	0	0	0	0	1
The Stanford Prison Experiment	1	0	0	0	0	1
A Dog's Purpose	1	0	0	0	0	1
Cat People	0	1	0	0	0	1
Microwave Massacre	0	0	0	0	1	1
	0	1	0	0	0	1
20 Million Miles to Earth	1	0	0	0	0	1
San Francisco	0	1	0	0	0	1
All About Lily Chou-Chou (Riri Shushu no subete)	0	0	1	0	0	1
Vampire Hunter D	0	0	1	0	0	1
Common Thread, A (a.k.a. Sequins) (Brodeuses)	1	0	0	0	0	1
The Loft	0	0	0	1	0	1
Me Without You	0	0	1	0	0	1
Fist Fight	1	0	0	0	0	1
Cocoanuts, The	0	1	0	0	0	1
Like Mike	0	0	1	0	0	1
Wagons East	0	0	0	1	0	1
Object of Beauty, The	0	0	0	1	0	1
Vice	0	0	0	0	1	1
Los Angeles Plays Itself	0	1	0	0	0	1
Snow Walker, The	0	0	1	0	0	1
Family Guy Presents: Blue Harvest	0	1	0	0	0	1
Airborne	0	0	1	0	0	1
Hey Arnold! The Movie	0	0	0	1	0	1
Trinity and Sartana Are Coming	1	0	0	0	0	1
Dominion: Prequel to the Exorcist	0	0	1	0	0	1
Saving Face	1	0	0	0	0	1
Kevin Hart: I'm a Grown Little Man	1	0	0	0	0	1
Jim Norton: American Degenerate	0	1	0	0	0	1
V. I. Warshawski	0	0	0	1	0	1
She Wore a Yellow Ribbon	0	0	1	0	0	1
Jim Jefferies: BARE	1	0	0	0	0	1
Shakespeare Behind Bars	0	0	1	0	0	1
Hombre	0	0	1	0	0	1
Hard Promises	0	0	0	1	0	1
Patton Oswalt: Tragedy Plus Comedy Equals Time	0	1	0	0	0	1
Wild Card	0	0	1	0	0	1
A Street Cat Named Bob	0	1	0	0	0	1
Bedazzled	0	0	0	1	0	1
Harvard Man	0	0	1	0	0	1
The Spirit of Christmas	0	0	0	1	0	1
Emperor's New Clothes, The	0	1	0	0	0	1
Godzilla: Final Wars (Gojira: Fainaru uôzu)	0	0	1	0	0	1
Wyrmwood	0	1	0	0	0	1
Saint Ralph	0	0	1	0	0	1
Rize	0	1	0	0	0	1
The Good Boy	0	1	0	0	0	1
Cherish	1	0	0	0	0	1
Perfect Crime, The (Crimen Ferpecto) (Ferpect Crime)	1	0	0	0	0	1
Cop and ½	0	0	0	1	0	1
At the Circus	0	0	1	0	0	1
The Boy Next Door	0	0	0	0	1	1
I Like It Like That	0	0	1	0	0	1
Rebound	0	0	1	0	0	1
Boy Meets Girl	0	1	0	0	0	1
The Dark Valley	0	0	1	0	0	1
I'm Here	0	1	0	0	0	1
Dana Carvey: Straight White Male, 60	1	0	0	0	0	1
CQ	0	0	1	0	0	1
The Last Five Years	0	1	0	0	0	1
Happy Endings	0	1	0	0	0	1
Marvel One-Shot: Agent Carter	0	1	0	0	0	1
Last Waltz, The	1	0	0	0	0	1
I Want to Live!	0	0	1	0	0	1
Kizumonogatari II: Passionate Blood	0	1	0	0	0	1
Hardware	0	0	0	1	0	1
Calcium Kid, The	1	0	0	0	0	1
Crimson Peak	0	1	0	0	0	1
November	0	0	1	0	0	1
Harvey Girls, The	0	0	1	0	0	1
Cranes Are Flying, The (Letyat zhuravli)	0	1	0	0	0	1
Calamity Jane	0	1	0	0	0	1
Lady and the Duke, The (Anglaise et le duc, L')	0	1	0	0	0	1
Georgy Girl	0	1	0	0	0	1
Order, The	0	0	1	0	0	1
De platte jungle	1	0	0	0	0	1
Mountains of the Moon	0	0	1	0	0	1
Dragonheart 3: The Sorcerer's Curse	0	1	0	0	0	1
Giant Spider Invasion, The	0	0	0	0	1	1
Butterflies Are Free	0	0	1	0	0	1
Miracles - Mr. Canton and Lady Rose	1	0	0	0	0	1
Hollywood Ending	0	1	0	0	0	1
He Said, She Said	0	0	0	1	0	1
Night and Day	0	0	1	0	0	1
Triumph of the Spirit	0	0	1	0	0	1
Jane Eyre	0	1	0	0	0	1
Pretty Persuasion	0	0	1	0	0	1
Full Moon in Blue Water	0	0	0	1	0	1
Joe Rogan: Live	0	1	0	0	0	1
The Natural Love	1	0	0	0	0	1
Jim Gaffigan: Cinco	0	0	1	0	0	1
Private Resort	0	0	0	1	0	1
Rain	1	0	0	0	0	1
Pusher II: With Blood on My Hands	0	0	1	0	0	1
Vampire in Venice (Nosferatu a Venezia) (Nosferatu in Venice)	1	0	0	0	0	1
Duma	0	1	0	0	0	1
World Traveler	0	1	0	0	0	1
Triumph of Love, The	0	0	0	1	0	1
Animal Farm	0	0	0	0	1	1
Teahouse of the August Moon, The	0	1	0	0	0	1
The Forgotten Space	0	1	0	0	0	1
Asterix & Obelix vs. Caesar (Astérix et Obélix contre César)	0	1	0	0	0	1
Watcher in the Woods, The	0	0	1	0	0	1
Cloudburst	0	1	0	0	0	1
Valiant	0	0	0	1	0	1
Taking Care of Business	0	0	1	0	0	1
Tom Segura: Completely Normal	1	0	0	0	0	1
Baxter, The	0	1	0	0	0	1
3:10 to Yuma	0	1	0	0	0	1
Honey, We Shrunk Ourselves	0	1	0	0	0	1
Delta Force, The	0	0	0	1	0	1
Johnny Express	1	0	0	0	0	1
New Police Story (Xin jing cha gu shi)	0	1	0	0	0	1
Go West	0	0	1	0	0	1
Frankenstein 90	0	1	0	0	0	1
Unfinished Life, An	0	0	1	0	0	1
Man, The	0	0	1	0	0	1
Eddie Izzard: Glorious	0	1	0	0	0	1
Lucky Break	0	1	0	0	0	1
Crush	0	0	1	0	0	1
Survive Style 5+	0	1	0	0	0	1
Bells of St. Mary's, The	0	1	0	0	0	1
Making a Murderer	0	1	0	0	0	1
Fraternity Vacation	0	0	0	0	1	1
Boxcar Bertha	0	0	0	1	0	1
Time Out (L'emploi du temps)	0	0	1	0	0	1
Piano Teacher, The (La pianiste)	0	1	0	0	0	1
No Such Thing	0	0	1	0	0	1
Northmen - A Viking Saga	0	0	0	1	0	1
Roll Bounce	0	0	0	1	0	1
Body Snatcher, The	1	0	0	0	0	1
Short Film About Love, A (Krótki film o milosci)	1	0	0	0	0	1
Body Parts	0	0	0	0	1	1
Blood Beach	0	0	0	0	1	1
All This, and Heaven Too	0	1	0	0	0	1
Darwin's Nightmare	0	1	0	0	0	1
Kizumonogatari III: Cold Blood	1	0	0	0	0	1
Beowulf & Grendel	0	0	1	0	0	1
Superfast!	0	0	0	0	1	1
Wraith, The	0	0	1	0	0	1
Shogun Assassin	1	0	0	0	0	1
Seems Like Old Times	1	0	0	0	0	1
Running Scared	0	1	0	0	0	1
Rude Boy	0	1	0	0	0	1
Reality	0	1	0	0	0	1
Taps	0	1	0	0	0	1
Road to Morocco	0	1	0	0	0	1
Georgia	0	1	0	0	0	1
Two for the Money	0	1	0	0	0	1
Audrey Rose	0	0	0	1	0	1
Dreamer: Inspired by a True Story	0	0	1	0	0	1
Harrison's Flowers	0	0	1	0	0	1
Don't Move (Non ti muovere)	1	0	0	0	0	1
Julia	0	0	0	1	0	1
This Property is Condemned	1	0	0	0	0	1
Night of the Lepus	0	0	1	0	0	1
Oh, God! Book II	0	0	0	1	0	1
Octagon, The	0	0	1	0	0	1
Ffolkes	0	0	0	1	0	1
Super, The	0	0	0	1	0	1
Ship of Fools	0	1	0	0	0	1
Long Good Friday, The	0	1	0	0	0	1
Little Darlings	0	0	0	1	0	1
Humanoids from the Deep	0	0	0	1	0	1
Day of the Locust, The	0	0	0	1	0	1
Wuthering Heights	0	0	1	0	0	1
Fun	0	1	0	0	0	1
Bungo Stray Dogs: Dead Apple	0	1	0	0	0	1
Match Factory Girl, The (Tulitikkutehtaan tyttö)	1	0	0	0	0	1
Great Gatsby, The	0	0	1	0	0	1
Royal Wedding	0	0	1	0	0	1
Elsa & Fred	0	1	0	0	0	1
Sword of the Beast (Kedamono no ken)	0	0	1	0	0	1
Big Doll House, The	0	0	1	0	0	1
Big Bird Cage, The	1	0	0	0	0	1
One-Way Ticket to Mombasa (Menolippu Mombasaan)	0	0	0	1	0	1
Creep	0	0	1	0	0	1
George Carlin: It's Bad for Ya!	1	0	0	0	0	1
Tracers	0	0	0	0	1	1
Blue Juice	0	0	0	1	0	1
100 Streets	0	0	1	0	0	1
Osama	0	1	0	0	0	1
Libertine, The	0	1	0	0	0	1
Hype!	1	0	0	0	0	1
McFarland, USA	0	1	0	0	0	1
Bird with the Crystal Plumage, The (Uccello dalle piume di cristallo, L')	0	1	0	0	0	1
Saturn 3	0	0	1	0	0	1
Stroszek	0	1	0	0	0	1
Crimson Gold (Talaye sorgh)	0	1	0	0	0	1
Designing Woman	0	1	0	0	0	1
Bad and the Beautiful, The	0	1	0	0	0	1
Ghost in the Shell Arise - Border 1: Ghost Pain	0	0	1	0	0	1
Last Orders	0	0	1	0	0	1
Good Son, The	0	0	0	1	0	1
Digging Up the Marrow	0	0	1	0	0	1
Return to Never Land	0	1	0	0	0	1
Clown	0	1	0	0	0	1
Samurai Rebellion (Jôi-uchi: Hairyô tsuma shimatsu)	0	1	0	0	0	1
Room for Romeo Brass, A	0	1	0	0	0	1
Don't Look Now	0	0	0	0	1	1
Wal-Mart: The High Cost of Low Price	1	0	0	0	0	1
Mozart and the Whale	0	0	1	0	0	1
Don't Look Now: We're Being Shot At (La grande vadrouille)	1	0	0	0	0	1
Cinderella	0	1	0	0	0	1
Scotland, Pa.	1	0	0	0	0	1
Kidnapping Mr. Heineken	0	0	0	1	0	1
Ear, The (Ucho)	0	1	0	0	0	1
Human Condition III, The (Ningen no joken III)	1	0	0	0	0	1
Going Places (Valseuses, Les)	1	0	0	0	0	1
Ruby Red	0	1	0	0	0	1
Dentist, The	0	0	1	0	0	1
Voices of a Distant Star (Hoshi no koe)	1	0	0	0	0	1
Cousins	0	0	1	0	0	1
Mercury Plains	0	0	0	1	0	1
Mudbound	0	0	1	0	0	1
While We're Young	0	1	0	0	0	1
Bill Burr: Walk Your Way Out	0	1	0	0	0	1
7 Faces of Dr. Lao	1	0	0	0	0	1
Maelström	0	1	0	0	0	1
Too Late for Tears	0	1	0	0	0	1
Beijing Bicycle (Shiqi sui de dan che)	0	1	0	0	0	1
Samurai Assassin (Samurai)	0	0	1	0	0	1
Boys of Baraka, The	0	1	0	0	0	1
Grand Theft Parsons	0	0	1	0	0	1
One-Eyed Jacks	0	0	1	0	0	1
La vérité si je mens !	0	1	0	0	0	1
Gunman, The	0	1	0	0	0	1
Little Dieter Needs to Fly	1	0	0	0	0	1
Looking for Comedy in the Muslim World	0	1	0	0	0	1
Brainstorm	0	1	0	0	0	1
Blankman	0	0	0	1	0	1
The Final Girls	0	0	1	0	0	1
Casper Meets Wendy	1	0	0	0	0	1
Revolution	0	0	1	0	0	1
Spring	1	0	0	0	0	1
Fifty Shades Darker	0	0	0	0	1	1
Fire and Ice	0	0	0	1	0	1
Bird People in China, The (Chûgoku no chôjin)	0	1	0	0	0	1
Water	0	1	0	0	0	1
Neal Brennan: 3 Mics	1	0	0	0	0	1
Power/Rangers	0	1	0	0	0	1
What Time Is It There? (Ni neibian jidian)	0	0	0	1	0	1
Bandidas	0	0	0	0	1	1
Helter Skelter	0	1	0	0	0	1
George Carlin: Life Is Worth Losing	1	0	0	0	0	1
Legend No. 17	1	0	0	0	0	1
Lemonade	1	0	0	0	0	1
Big Momma's House 2	0	0	0	1	0	1
Tuskegee Airmen, The	0	0	0	1	0	1
Something New	1	0	0	0	0	1
Imagine Me & You	0	1	0	0	0	1
Yentl	0	1	0	0	0	1
Love and Pigeons	1	0	0	0	0	1
That Sugar Film	1	0	0	0	0	1
London	0	0	1	0	0	1
Freedomland	0	0	0	1	0	1
Topkapi	0	0	1	0	0	1
Winter Passing	0	1	0	0	0	1
Defiant Ones, The	0	1	0	0	0	1
Just My Luck	0	0	1	0	0	1
Saving Santa	1	0	0	0	0	1
The Brain	1	0	0	0	0	1
Ask the Dust	0	1	0	0	0	1
Tom and Jerry: A Nutcracker Tale	1	0	0	0	0	1
Find Me Guilty	0	0	1	0	0	1
What Men Talk About	1	0	0	0	0	1
White Water Summer	0	0	0	1	0	1
Kill Me Three Times	0	0	1	0	0	1
Poker Night	0	0	0	1	0	1
Clockwise	0	1	0	0	0	1
Leprechaun 2	0	0	1	0	0	1
Leprechaun 3	0	0	0	1	0	1
Leprechaun 4: In Space	0	0	0	0	1	1
Reckless Kelly	0	0	1	0	0	1
Lights in the Dusk (Laitakaupungin valot)	0	1	0	0	0	1
Willy/Milly	1	0	0	0	0	1
Unknown White Male	0	1	0	0	0	1
Youth of the Beast (Yaju no seishun)	0	1	0	0	0	1
Raising Cain	0	0	0	0	1	1
Blue Angel, The (Blaue Engel, Der)	0	1	0	0	0	1
Devil and Daniel Johnston, The	1	0	0	0	0	1
Mouchette	0	0	1	0	0	1
Incredible Shrinking Man, The	0	0	1	0	0	1
The Jinx: The Life and Deaths of Robert Durst	1	0	0	0	0	1
Baran	0	1	0	0	0	1
Brainstorm	0	0	1	0	0	1
Texas Rangers	0	0	0	1	0	1
Pornstar: The Legend of Ron Jeremy	0	0	1	0	0	1
Batman vs. Robin	0	0	1	0	0	1
Dead Hate the Living!, The	0	0	1	0	0	1
Libre et assoupi	0	0	1	0	0	1
American Fable	0	0	1	0	0	1
Evil Aliens	1	0	0	0	0	1
People That Time Forgot, The	0	0	1	0	0	1
Morons From Outer Space	0	0	0	1	0	1
Renaissance	0	0	1	0	0	1
Woman in Gold	0	1	0	0	0	1
Eye for an Eye, An	0	1	0	0	0	1
Enforcer, The	0	1	0	0	0	1
Angry Red Planet, The	1	0	0	0	0	1
Go for Zucker! (Alles auf Zucker!)	1	0	0	0	0	1
Final Countdown, The	0	0	1	0	0	1
Woman Is a Woman, A (femme est une femme, Une)	1	0	0	0	0	1
Dressed to Kill	0	0	0	0	1	1
The Road Within	1	0	0	0	0	1
Secrets of a Soul (Geheimnisse einer Seele)	1	0	0	0	0	1
Last Wave, The	0	0	1	0	0	1
Everybody's Famous! (Iedereen beroemd!)	0	0	0	1	0	1
Cheap Detective, The	0	0	1	0	0	1
Child, The (L'enfant)	0	1	0	0	0	1
The Void	0	0	0	1	0	1
The Malibu Bikini Shop	0	0	0	0	1	1
MacArthur	0	1	0	0	0	1
Guyver: Dark Hero	0	0	0	1	0	1
9/11	1	0	0	0	0	1
Let It Be Me	0	0	1	0	0	1
Wild, The	0	0	1	0	0	1
Buzzard	1	0	0	0	0	1
Seve	1	0	0	0	0	1
American Dreamz	0	0	1	0	0	1
Protector, The (a.k.a. Warrior King) (Tom yum goong)	0	0	1	0	0	1
Breathe	0	0	0	0	1	1
Patlabor 2: The Movie	0	1	0	0	0	1
Peaceful Warrior	1	0	0	0	0	1
Monster in a Box	0	1	0	0	0	1
Game 6	0	0	1	0	0	1
Camille	0	1	0	0	0	1
On a Clear Day	0	0	0	1	0	1
Career Opportunities	0	0	1	0	0	1
I Am a Sex Addict	1	0	0	0	0	1
Stoned	0	0	0	1	0	1
Girltrash: All Night Long	0	1	0	0	0	1
Domestic Disturbance	0	0	0	1	0	1
Town is Quiet, The (Ville est tranquille, La)	0	1	0	0	0	1
Sword of Vengeance	0	0	0	0	1	1
Public Eye, The	0	0	0	1	0	1
High Heels and Low Lifes	0	0	1	0	0	1
Road to Guantanamo, The	0	1	0	0	0	1
Better Than Sex	0	1	0	0	0	1
OH in Ohio, The	0	0	1	0	0	1
Fallen Idol, The	0	0	1	0	0	1
Strangers with Candy	0	0	1	0	0	1
Focus	0	1	0	0	0	1
Army of Shadows (L'armée des ombres)	1	0	0	0	0	1
Orchestra Rehearsal (Prova d'orchestra)	0	1	0	0	0	1
Little Man	0	0	0	0	1	1
Titanica	0	0	1	0	0	1
Lovesick	0	0	0	1	0	1
Danny Collins	1	0	0	0	0	1
Making the Grade	0	0	0	1	0	1
The Even Stevens Movie	0	1	0	0	0	1
Secret Life of Words, The	0	1	0	0	0	1
Walking Dead, The	0	0	1	0	0	1
Chaos	0	1	0	0	0	1
Kite	0	0	0	1	0	1
Zoom	0	0	1	0	0	1
Rivers and Tides	1	0	0	0	0	1
Body Double	0	0	1	0	0	1
Buster's Mal Heart	0	0	0	0	1	1
Moustache, La	0	1	0	0	0	1
Last Metro, The (Dernier métro, Le)	0	1	0	0	0	1
Comedy Central Roast of James Franco	0	0	1	0	0	1
Power Rangers	0	0	1	0	0	1
Free Fire	0	1	0	0	0	1
Can't Stop the Music	0	0	1	0	0	1
Brubaker	0	1	0	0	0	1
Party, The (Boum, La)	0	1	0	0	0	1
Boogeyman, The	0	0	1	0	0	1
We Could Be King	0	1	0	0	0	1
Swamp, The (Ciénaga, La)	0	0	1	0	0	1
Material Girls	0	0	0	1	0	1
Hitman: Agent 47	0	0	0	1	0	1
Crime Busters	0	0	1	0	0	1
Extreme Days	0	0	0	1	0	1
Born to Kill	0	1	0	0	0	1
Idlewild	0	1	0	0	0	1
Red Balloon, The (Ballon rouge, Le)	0	1	0	0	0	1
When Worlds Collide	1	0	0	0	0	1
Chump at Oxford, A	1	0	0	0	0	1
B/W	0	1	0	0	0	1
I Never Promised You a Rose Garden	0	0	0	1	0	1
Species III	0	0	0	0	1	1
Icicle Thief, The (Ladri di saponette)	0	0	1	0	0	1
Pocketful of Miracles	0	1	0	0	0	1
Puffy Chair, The	0	0	1	0	0	1
Severance	0	0	1	0	0	1
Ricki and the Flash	0	0	0	1	0	1
King Solomon's Mines	0	0	1	0	0	1
Covenant, The	0	0	1	0	0	1
Indiscreet	0	1	0	0	0	1
Partisan	0	0	0	1	0	1
Ultimate Avengers 2	0	0	0	1	0	1
Infini	0	0	0	1	0	1
SherryBaby	0	0	1	0	0	1
Dave Chappelle: The Age of Spin	0	1	0	0	0	1
Moscow Does Not Believe in Tears (Moskva slezam ne verit)	1	0	0	0	0	1
Bow, The (Hwal)	0	1	0	0	0	1
Legend of Hell House, The	0	0	0	0	1	1
Great Silence, The (Grande silenzio, Il)	0	1	0	0	0	1
Just Before I Go	0	0	0	0	1	1
Endurance: Shackleton's Legendary Antarctic Expedition, The	0	1	0	0	0	1
Carol	0	1	0	0	0	1
Desert Hearts	1	0	0	0	0	1
American Astronaut, The	0	0	1	0	0	1
Tiger and the Snow, The (La tigre e la neve)	0	1	0	0	0	1
Glitter	0	0	0	0	1	1
Fear City: A Family-Style Comedy (La cité de la peur)	0	1	0	0	0	1
Woods, The	0	0	1	0	0	1
Dinner Rush	0	1	0	0	0	1
Tilt	0	0	0	1	0	1
Bootleggers	1	0	0	0	0	1
Into the Arms of Strangers: Stories of the Kindertransport	0	0	1	0	0	1
Our Lady of the Assassins (Virgen de los sicarios, La)	0	1	0	0	0	1
CHiPS	0	1	0	0	0	1
Two Can Play That Game	0	1	0	0	0	1
Sum of Us, The	0	1	0	0	0	1
Güeros	0	0	1	0	0	1
Maggie	0	0	0	1	0	1
3 Ninjas Knuckle Up	0	0	0	0	1	1
Hot Pursuit	0	0	0	1	0	1
Land of Plenty (Angst and Alienation in America)	0	1	0	0	0	1
Bridge, The	0	1	0	0	0	1
Flyboys	0	0	0	1	0	1
Captains Courageous	0	1	0	0	0	1
The Green Inferno	0	1	0	0	0	1
Maybe Baby	0	1	0	0	0	1
Barely Lethal	1	0	0	0	0	1
Table 19	0	0	1	0	0	1
School for Scoundrels	0	0	1	0	0	1
Carry On Don't Lose Your Head	0	1	0	0	0	1
Fullmetal Alchemist 2018	0	0	0	0	1	1
Running With Scissors	0	0	1	0	0	1
What Love Is	1	0	0	0	0	1
The Monkey King	0	1	0	0	0	1
5 to 7	0	0	1	0	0	1
Suture	0	0	1	0	0	1
All Over the Guy	0	0	1	0	0	1
Chapayev	1	0	0	0	0	1
Afonya	0	1	0	0	0	1
My Love	1	0	0	0	0	1
U.S. vs. John Lennon, The	0	1	0	0	0	1
Battle Creek Brawl (Big Brawl, The)	0	1	0	0	0	1
Awakening, The	0	0	1	0	0	1
Radio Day	1	0	0	0	0	1
13 Tzameti	1	0	0	0	0	1
Return to Sender	0	0	0	1	0	1
Shootist, The	0	1	0	0	0	1
Dave Chappelle: Deep in the Heart of Texas	0	1	0	0	0	1
Elections Day	1	0	0	0	0	1
